Agathon	m
Alexios	m
Ambrosia	f
Ambrosios	m
Ampelios	m
Amyntas	m
Anakletos	m
Anatolios	m
Anaxagoras	m
Andronikos	m
Anthousa	f
Aphrodisia	f
Aphrodisios	m
Apollinaris	m
Apollodoros	m
Apollonia	f
Apollonios	m
Archimedes	m
Archippos	m
Argyros	m
Aristarchos	m
Aristeides	m
Aristokles	m
Aristomache	f
Ariston	m
Aristophanes	m
Aristoteles	m
Arkadios	m
Arsenios	m
Artemidoros	m
Artemisia	f
Artemisios	m
Asklepiades	m
Aspasia	f
Athanas	m
Athenais	f
Basileios	m
Berenike	f
Bion	m
Chariton	m
Charmion	f
Damianos	m
Demetria	f
Demon	m
Demosthenes	m
Demostrate	f
Diodoros	m
Diodotos	m
Diogenes	m
Diokles	m
Dionysodoros	m
Eirenaios	m
Epaphroditos	m
Epiktetos	m
Erasmos	m
Euaristos	m
Eudokia	f
Eudoxia	f
Eugeneia	f
Eugenios	m
Eukleides	m
Eumelia	f
Eunike	f
Euphemia	f
Euphemios	m
Euphranor	m
Eupraxia	f
Euripides	m
Eusebios	m
Eustachus	m
Eustathios	m
Eustorgios	m
Euthalia	f
Euthymios	m
Eutropia	f
Eutropios	m
Eutychios	m
Hagne	f
Herakleides	m
Herakleios	m
Herakleitos	m
Hermogenes	m
Hermokrates	m
Hermolaos	m
Heron	m
Hieronymos	m
Hilarion	m
Hippokrates	m
Hyginos	m
Hypatia	f
Isidoros	m
Kallias	m
Kallikrates	m
Kallistos	m
Kallistrate	f
Kleisthenes	m
Kleitos	m
Kleon	m
Kleopatra	f
Kleopatros	m
Korinna	f
Kosmas	m
Kyrillos	m
Leontios	m
Lysandra	f
Methodios	m
Metrophanes	m
Miltiades	m
Myrrine	f
Nikandros	m
Nikias	m
Nikodemos	m
Nikolaos	m
Nikomachos	m
Nikomedes	m
Nikostratos	m
Olympias	f
Olympiodoros	m
Olympos	m
Pamphilos	m
Pankratios	m
Pantaleon	m
Panther	m
Pantheras	m
Paramonos	m
Pelagios	m
Pherenike	f
Phile	f
Philokrates	m
Philon	m
Philotheos	m
Phokas	m
Photine	f
Praxiteles	m
Prokopios	m
Ptolemaios	m
Ptolemais	f
Pythagoras	m
Sappho	f
Simonides	m
Sokrates	m
Solon	m
Sosigenes	m
Sostrate	f
Straton	m
Thais	f
Thales	m
Theodosia	f
Theodosios	m
Theodotos	m
Theodoulos	m
Theokritos	m
Theophanes	m
Theophila	f
Theophilos	m
Theron	m
Timo	f
Timothea	f
Tychon	m
Xanthippe	f
Xenon	m
Xenophon	m
Zenais	f
Zenobia	f
Zenobios	m
Zopyros	m
Zosime	f
Zosimos	m
Zotikos	m
Dareios	m
Eutychos	m
Karpos	m
Kyros	m
Onesimos	m
Onesiphoros	m
Philippos	m
Stephanos	m
Timotheos	m
Timon	m
Dion	m
Charis	f
Melitta	f
Aristodemos	m
Elpis	f
Nikephoros	mf
Pelagia	f
Zenon	m
Nikon	m
Platon	m
Erastos	m
Mnason	m
Tryphosa	f
Epaphras	m
Syntyche	f
Myron	m
Melissa	f
Chloe	f
Doris	f
Leon	m
Theodora	f
Zoe	f
Sophia	f
Agathe	f
Alexis	mf
Andreas	m
Helene	f
Alexandra	f
Eirene	f
Hippolytos	m
Hyakinthos	m
Kallisto	f
Ligeia	f
Nike	f
Phoibos	m
Pyrrhos	m
Xanthe	f
Zephyros	m
Phoibe	f
Agape	f
Agapios	m
Aikaterine	f
Akakios	m
Anastasios	m
Aniketos	m
Athanasia	f
Athanasios	m
Chrysanthe	f
Chrysanthos	m
Demetrios	m
Dionysios	m
Georgios	m
Kyriakos	m
Leonidas	m
Photios	m
Theodoros	m
Theophania	f
Theophylaktos	m
Tryphon	m
Xenia	f
Alexandros	m
Anastasia	f
Isidora	f
Eulalia	f
