Aelia	f
Aeliana	f
Aelianus	m
Aelius	m
Aemilia	f
Aemiliana	f
Aemilianus	m
Aemilius	m
Agrippina	f
Albinus	m
Antoninus	m
Appius	m
Aquilina	f
Aquilinus	m
Atilius	m
Augustina	f
Augustinus	m
Aulus	m
Aurelianus	m
Aurelius	m
Avitus	m
Balbina	f
Blandina	f
Blandinus	m
Blandus	m
Blasius	m
Caecilius	m
Caelia	f
Caelina	f
Caelinus	m
Caelius	m
Caesar	m
Caius	m
Camillus	m
Cassia	f
Cassianus	m
Cato	m
Celsus	m
Cicero	m
Claudius	m
Cloelia	f
Cloelius	m
Cnaeus	m
Crispinus	m
Crispus	m
Cyprianus	m
Decima	f
Decimus	m
Domitia	f
Domitianus	m
Domitius	m
Drusa	f
Drusus	m
Egnatius	m
Fabianus	m
Fabius	m
Fabricia	f
Fabricius	m
Faustinus	m
Faustus	m
Flavianus	m
Flavius	m
Florianus	m
Florus	m
Fulvius	m
Gaius	m
Gallus	m
Germanus	m
Gnaeus	m
Hadriana	f
Hadrianus	m
Herminius	m
Hilarius	m
Horatia	f
Horatius	m
Iulianus	m
Iulius	m
Laelia	f
Laurentia	f
Laurentina	f
Laurentinus	m
Laurentius	m
Livianus	m
Livius	m
Longinus	m
Lucianus	m
Lucretia	f
Marcellina	f
Marcellinus	m
Marcius	m
Marianus	m
Martinus	m
Maxima	f
Maximianus	m
Maximiliana	f
Maximilianus	m
Maximinus	m
Maximus	m
Nero	m
Nerva	m
Octavianus	m
Octavius	m
Otho	m
Ovidius	m
Paulinus	m
Paulus	m
Petronia	f
Petronius	m
Pompeius	m
Pomponia	f
Pomponius	m
Priscus	m
Publius	m
Quintillus	m
Quintina	f
Quintus	m
Regulus	m
Rufinus	m
Sabinus	m
Saturninus	m
Secundinus	m
Secundus	m
Seneca	m
Septimius	m
Septimus	m
Sergius	m
Servius	m
Severianus	m
Severinus	m
Severus	m
Sextilius	m
Sextus	m
Spurius	m
Tacita	f
Tacitus	m
Tatianus	m
Terentius	m
Tertius	m
Thracius	m
Tiberius	m
Tiburtius	m
Titiana	f
Titianus	m
Tullius	m
Valentinus	m
Valeriana	f
Valerianus	m
Valerius	m
Varinius	m
Varius	m
Vergilius	m
Vespasianus	m
Vibiana	f
Vibianus	m
Vibius	m
Vita	f
Vitus	m
Agrippa	mf
Festus	m
Pontius	m
Lucius	m
Titus	m
Antonius	m
Augustus	m
Marinus	m
Cassius	m
Rufus	m
Marcus	m
Cornelius	m
Julius	m
Marcellus	m
Marius	m
Faustina	f
Aurelia	f
Hilaria	f
Hortensia	f
Saturnina	f
Septima	f
Varinia	f
Aquila	mf
Junia	f
Drusilla	f
Prisca	f
Juliana	f
Octavia	f
Priscilla	f
Claudia	f
Julia	f
Cornelia	f
Camilla	f
Virginia	f
Marcia	f
Caecilia	f
Regula	f
Felix	m
Paula	f
Augusta	f
Martina	f
Domitilla	f
Fabia	f
Fausta	f
Floriana	f
Fulvia	f
Liviana	f
Lucilla	f
Tullia	f
Marcella	f
Lucia	f
Antonina	f
Albina	f
Severina	f
Livia	f
Valentina	f
Antonia	f
Fabiola	f
Fabiana	f
Luciana	f
Marina	f
Sabina	f
Flavia	f
Valeria	f
Tatius	m
Iulia	f
Iuliana	f
Rufina	f
Tatiana	f
Herminia	f
Paulina	f
Mariana	f
