Áki	m
Áleifr	m
Alfarr	m
Alfhildr	f
Arnbjörg	f
Arnþórr	m
Arnviðr	m
Ása	f
Ásbjörn	m
Ásgeirr	m
Áslaug	f
Ásmundr	m
Ásta	f
Ástríðr	f
Ásvaldr	m
Bergljót	f
Birgir	m
Bjarni	m
Bjartr	m
Dagný	f
Egill	m
Eileifr	m
Eiríkr	m
Erlendr	m
Erlingr	m
Eyvindr	m
Fólki	m
Friðþjófr	m
Gautstafr	m
Gunnhildr	f
Gunnvör	f
Guðfriðr	m
Haraldr	m
Helgi	m
Herleifr	m
Hróarr	m
Hrrekr	m
Hrólfr	m
Hróðgeirr	m
Hróðólfr	m
Ingi	m
Ingibjörg	f
Ingigerðr	f
Ingimárr	m
Ingólfr	m
Ingríðr	f
Ingvarr	m
Ingvildr	f
Ívarr	m
Knútr	m
Kóri	m
Ragnarr	m
Ragnbjörg	f
Ragnfríðr	f
Ragnheiðr	f
Ragnhildr	f
Ragnvaldr	m
Randúlfr	m
Ráðúlfr	m
Sigfrøðr	m
Sigmundr	m
Sigríðr	f
Sólveig	f
Stígandr	m
Sveinn	m
Þóra	f
Þórbjörg	f
Þórbjörn	m
Þórfríðr	f
Þórgeirr	m
Þórgísl	m
Þórgnýr	m
Þórhildr	f
Þórketill	m
Þórmóðr	m
Þórný	f
Þórsteinn	m
Þórvaldr	m
Þýri	f
Úlfr	m
Vígdís	f
Ari	m
Eydís	f
Eysteinn	m
Fríða	f
Guðlaug	f
Guðrún	f
Hákon	m
Hallbjörn	m
Hjördís	f
Snorri	m
Þórdís	f
Valdís	f
Gunnarr	m
Signý	f
Sigurðr	m
Svanhildr	f
Sigrún	f
Ásdís	f
Aðalbjörg	f
Aðalsteinn	m
Hrafn	m
Þórir	m
Grímhildr	f
Iðunn	f
Sindri	m
Helga	f
Inga	f
Jarl	m
Björn	m
