Acacius	m
Aeschylus	m
Alcaeus	m
Alexius	m
Ambrosius	m
Ampelius	m
Anacletus	m
Anastasius	m
Anatolius	m
Androcles	m
Anicetus	m
Antigonus	m
Antipater	m
Arcadius	m
Aristarchus	m
Aristides	m
Aristocles	m
Arsenius	m
Athanasius	m
Basilius	m
Cleon	m
Cleopatra	f
Clitus	m
Cosmas	m
Cyrillus	m
Damianus	m
Demetrius	m
Democritus	m
Diodorus	m
Diodotus	m
Draco	m
Eudocia	f
Eugenius	m
Eusebius	m
Eustachius	m
Eustorgius	m
Euthymius	m
Eutropius	m
Eutychius	m
Evaristus	m
Gaiana	f
Gennadius	m
Georgius	m
Heracleitus	m
Heraclius	m
Hero	m
Herodotus	m
Hippocrates	m
Hyginus	m
Ireneus	m
Isocrates	m
Leontius	m
Lysander	m
Lysimachus	m
Lysistrata	f
Methodius	m
Pancratius	m
Pelagius	m
Pericles	m
Phaedrus	m
Philo	m
Phocas	m
Plato	m
Seleucus	m
Socrates	m
Sophocles	m
Sophus	m
Themistocles	m
Theocritus	m
Theodosius	m
Theodotus	m
Theodulus	m
Thucydides	m
Timoteus	m
Tycho	m
Xenocrates	m
Zeno	m
Zosimus	m
Zoticus	m
Archelaus	m
Dionysius	m
Timaeus	m
Theodorus	m
Achaicus	m
Nicodemus	m
Prochorus	m
Theophilus	m
Eunice	f
Agatha	f
Cyrus	m
Jason	m
Corinna	f
Agnes	f
Alexander	m
Berenice	f
Irene	f
Hieronymus	m
Nicolaus	m
Helena	f
Hyacinthus	m
Lycurgus	m
Pyrrhus	m
Eugenia	f
