Adalberht	m
Adalbern	m
Adalfuns	m
Adalheidis	f
Adalwin	m
Adalwolf	m
Adelais	f
Adelmar	m
Alaric	m
Alboin	m
Alfbern	m
Alfher	m
Alfwin	m
Allovera	f
Amalasuintha	f
Amalric	m
Amelina	f
Angilberct	m
Ansehelm	m
Ansigar	m
Ansobert	m
Anzo	m
Archembald	m
Athanaric	m
Auda	f
Audo	m
Aveza	f
Baldarich	m
Baldomar	m
Baldovin	m
Berahthraban	m
Berahthram	m
Berhta	f
Berhtoald	m
Berinhard	m
Carlman	m
Chariovalda	m
Clothildis	f
Conigunde	f
Eburwin	m
Egilhard	m
Ekkebert	m
Emelrich	m
Ercanbald	m
Ermendrud	f
Ermenrich	m
Ermingard	f
Erminhilt	f
Erminigild	m
Erminlinda	f
Ernust	m
Faramund	m
Franco	m
Friduhelm	m
Friduric	m
Fridwald	m
Fulco	m
Gaufrid	m
Gerbern	m
Gerfrid	m
Gerlind	f
Giselbert	m
Gisila	f
Gisilbert	m
Gisilfrid	m
Godafrid	m
Gumarich	m
Gundhram	m
Hadewig	f
Hadufuns	m
Hardman	m
Hardmod	m
Harduwich	m
Hardwin	m
Haribert	m
Hariman	m
Hariwald	m
Hariwini	m
Heimirich	m
Helewidis	f
Helmo	m
Hengist	m
Hildefons	m
Hildiberht	m
Hildigardis	f
Hludowig	m
Horsa	m
Hrodebert	m
Hroderich	m
Hrodger	m
Hrodland	m
Hrodohaidis	f
Hrodpreht	m
Hrodulf	m
Hrolf	m
Huguo	m
Hulderic	m
Hunfrid	m
Ishild	f
Jordanes	m
Landebert	m
Leudbald	m
Liupold	m
Mahthildis	f
Meginhard	m
Odalric	m
Odila	f
Odilia	f
Odo	m
Odovacar	m
Raban	m
Radulf	m
Raganhar	m
Raganhildis	f
Raginald	m
Raginhard	m
Raginmund	m
Rainard	m
Randulf	m
Reinald	m
Ricohard	m
Roslindis	f
Rosmunda	f
Rothaid	f
Roza	f
Sigibert	m
Sigifrid	m
Sigihard	m
Sigihild	f
Sigilind	f
Sigimund	m
Swanahilda	f
Tancred	m
Theoderich	m
Þeodoard	m
Theothelm	m
Þeudelinda	f
Þeudemar	m
Þeudhar	m
Þeudobald	m
Þeudofrid	m
Þeutrich	m
Þiudreiks	m
Vulferam	m
Vulfgang	m
Walahfrid	m
Waldeburg	f
Waldhar	m
Walherich	m
Wandal	m
Wandalin	m
Wido	m
Wigburg	f
Willabert	m
Willahelm	m
Willifrid	m
Gundahar	m
Adalbert	m
Gerlach	m
Avila	f
Theobald	m
Baldwin	m
Herman	m
Gilbert	m
Richard	m
Albert	m
Emma	f
Bernard	m
Robert	m
Arnold	m
Bertram	m
Conrad	m
Waldo	m
Hilda	f
Walter	m
Leonard	m
Amelia	f
Adela	f
Mathilda	f
Aldric	m
Bertrand	m
Lamprecht	m
Ava (3)	f
Eberhard	m
Ekkehard	m
Emmerich	m
Engelbert	m
Ewald	m
Gerhild	f
Gernot	m
Gerold	m
Gertrud	f
Gerulf	m
Gervas	m
Gisbert	m
Hartmut	m
Hartwig	m
Hartwin	m
Heinrich	m
Hildebrand	m
Lanzo	m
Oda	f
Raimund	m
Rainer	m
Reiner	m
Reinhard	m
Reinhold	m
Sigismund	m
Walther	m
Wolfgang	m
Alwin	m
Erwin	m
Filibert	m
Ivo	m
Wendelin	m
Lambert	m
Alfons	m
Bernhard	m
Adolf	m
Gerhard	m
Anselm	m
Bertha	f
Ulrich	m
Ferdinand	m
Irma	f
Wilhelm	m
Ansgar	m
Hildegard	f
Otto	m
Karl	m
Carloman	m
Alda	f
Aldo	m
Frida	f
