Ælfgar	m
Ælfgifu	f
Ælfheah	m
Ælfræd	m
Ælfric	m
Ælfþryð	f
Ælfwine	m
Ælred	m
Æsc	m
Æðelbeorht	m
Æðelflæd	f
Æðelfrið	m
Æðelmær	m
Æðelred	m
Æðelric	m
Æðelstan	m
Æðelþryð	f
Æðelwine	m
Cerdic	m
Cyneburga	f
Cynefrið	m
Eadberht	m
Eadburga	f
Eadgar	m
Eadgyð	f
Eadmund	m
Eadweard	m
Eadwig	m
Eadwine	m
Ealdgyð	f
Ealdræd	m
Eastmund	m
Ecgberht	m
Eoforhild	f
Eoforwine	m
Friðuswiþ	f
Godric	m
Godwine	m
Hereward	m
Hereweald	m
Hild	f
Hroðgar	m
Leofric	m
Leofwine	m
Osbeorn	m
Osberht	m
Osgar	m
Osmund	m
Oswine	m
Sigeberht	m
Sunngifu	f
Wilburh	f
Wilfrið	m
Wilheard	m
Wine	m
Winfrið	m
Wulfric	m
Oswald	m
