Aali	m
Aamina	f
Abbas	m
Abd Al Aziz	m
Abd Al Hamid	m
Abd Al Kader	m
Abd Al Karim	m
Abd Allah	m
Abd Al Latif	m
Abd Al Malik	m
Abd Al Qadir	m
Abd Al Rahman	m
Abdul	m
Abdul Aziz	m
Abdul Hamid	m
Abdullah	m
Abdul Rahman	m
Abla	f
Adel	m
Adil	m
Afaf	f
Afif	m
Afra	f
Afzal	m
Ahmad	m
Aisha	f
Akeem	m
Akilah	f
Ala	m
Ala Al Din	m
Ali	m
Alia	f
Alim	m
Alina	f
Aliya	f
Aliyah	f
Aliyya	f
Aliyyah	f
Almas	f
Alya	f
Amal	mf
Amani	f
Amin	m
Amina	f
Aminah	f
Amir	m
Amira	f
Amirah	f
Amna	f
Anas	m
Anass	m
Anisa	f
Anwar	m
Anwer	m
Aqil	m
Aqila	f
Arij	f
Arwa	f
As'ad	m
Asad	m
Asif	m
Asim	m
Asma	f
Asmaa	f
Ata	m
Atallah	m
Ataullah	m
Atiya	f
Atuf	m
Ayda	f
Ayesha	f
Ayishah	f
Ayman	m
Azhar	m
Aziz	m
Badr	mf
Baha	m
Bahiga	f
Bahij	m
Bahija	f
Bahiyya	f
Baki	m
Bakr	m
Baqi	m
Baqir	m
Barack	m
Barak	m
Barakat	m
Basil	m
Basim	m
Basima	f
Basir	m
Basira	f
Basit	m
Basma	f
Bassam	m
Bassem	m
Batul	f
Bilal	m
Botros	m
Boulos	m
Boutros	m
Dalal	f
Daud	m
Dawood	m
Dawud	m
Dema	f
Dima	f
Diya	m
Djamila	f
Dua	f
Duha	mf
Essa	m
Fadi	m
Fadia	f
Fadil	m
Fadila	f
Fadl	m
Fahd	m
Fahim	m
Fahima	f
Fairuz	f
Faiz	m
Faiza	f
Faizel	m
Fakhri	m
Fakhriyya	f
Farag	m
Farah	mf
Faraj	m
Fareed	m
Farid	m
Farida	f
Fariha	f
Faris	m
Farooq	m
Farouk	m
Farrah	f
Faruq	m
Fathi	m
Fathiyya	f
Fatima	f
Fatimah	f
Fatin	f
Fatma	f
Fawzi	m
Fawziya	f
Fawziyya	f
Fayiz	m
Fayruz	f
Faysal	m
Fayza	f
Fidda	f
Fihr	m
Fikri	m
Fikriyya	f
Firdos	m
Fizza	f
Fouad	m
Fuad	m
Gabir	m
Gabr	m
Gafar	m
Galal	m
Galila	f
Gamal	mf
Gamil	m
Gamila	f
Gathbiyya	f
Gauhar	f
Gawahir	f
Gawdat	m
Gazbiyya	f
Ghada	f
Ghadir	f
Ghalib	m
Ghaliya	f
Ghassan	m
Ghayth	m
Ghufran	mf
Guda	m
Habib	m
Habiba	f
Hadi	m
Hadia	f
Hadil	f
Hadiya	f
Hadiyya	f
Hadjara	f
Hadya	f
Hafeez	m
Hafiz	m
Hafsa	f
Hafsah	f
Hafza	f
Hagir	f
Haidar	m
Haider	m
Haifa	f
Hajar	f
Hakeem	m
Hakim	m
Hala	f
Hameed	m
Hamid	m
Hamza	m
Hana	f
Hanaa	f
Hanan	f
Hani	m
Hanif	m
Hanifa	f
Haniyya	f
Harith	m
Haroun	m
Harun	m
Hasan	m
Hashim	m
Hasib	m
Hasim	m
Hassan	m
Hatim	m
Hayder	m
Hayfa	f
Haytham	m
Hesham	m
Hiba	f
Hikmat	mf
Hind	f
Hisein	m
Hisham	m
Hooda	f
Hosni	m
Houda	f
Houssam	m
Huda	f
Husain	m
Husam	m
Husayn	m
Husni	m
Hussain	m
Hussein	m
Hyder	m
Ibraheem	m
Ibrahim	m
Ibtihaj	f
Ibtisam	f
Ihab	mf
Ihsan	mf
Ikraam	mf
Ikram	mf
Ilyas	m
Imad	m
Imam	m
Iman	mf
Imen	m
Imran	m
Imtiyaz	m
In'am	f
Inas	f
Iqbal	m
Irfan	m
Isa	m
Isam	m
Isma'il	m
Ismat	mf
Isra	f
Issa	m
I'tidal	f
I'timad	mf
Izdihar	f
Izz Al Din	m
Izz Ud Din	m
Jabbar	m
Jabir	m
Jabr	m
Jabril	m
Jafar	m
Jaffar	m
Jaffer	m
Jalal	m
Jalila	f
Jamaal	m
Jamal	mf
Jameel	m
Jameela	f
Jamil	m
Jamila	f
Jamillah	f
Janan	f
Jathbiyya	f
Jathibiyya	f
Jawahir	f
Jawdat	mf
Jibril	m
Jinan	mf
Juda	m
Jumana	f
Jumanah	f
Junaid	m
Junayd	m
Kader	m
Kamal	m
Kamil	m
Karam	mf
Kareem	m
Karim	m
Karima	f
Khadiga	f
Khadija	f
Khaled	m
Khaleel	m
Khalid	m
Khalida	f
Khalifa	m
Khalil	m
Khalilah	f
Khaliq	m
Khatijah	f
Khayrat	mf
Khayri	m
Khayriyya	f
Khayyam	m
Lamis	f
Lamya	f
Lateefah	f
Latif	m
Latifa	f
Latifah	f
Lawahiz	f
Lina	f
Lubna	f
Lujayn	f
Lulu	f
Lutfi	m
Maha	f
Mahfuz	m
Mahir	m
Mahmood	m
Mahmoud	m
Mahmud	m
Mahomet	m
Majid	m
Makram	m
Malaika	f
Malak	mf
Malik	m
Malika	f
Mansoor	m
Mansur	m
Maram	mf
Mariam	f
Marwa	f
Maryam	f
Masood	m
Mas'ud	m
Mazin	m
Mehmood	m
Mehmud	m
Midha	f
Midhat	m
Mihammad	m
Miraj	m
Mis'id	m
Mohamed	m
Mohammad	m
Mohammed	m
Mona (3)	f
Mostafa	m
Mouna	f
Mubin	m
Mubina	f
Mufaddal	m
Muhammad	m
Muhammed	m
Muhsin	m
Muhsina	f
Mukhtar	m
Mumina	f
Muna	f
Munir	m
Munira	f
Munya	f
Murad	m
Murtada	m
Murtaza	m
Mus'ad	m
Mustafa	m
Mustapha	m
Mu'tamid	m
Mu'tasim	m
Nabil	m
Nada	f
Nader	m
Nadia	f
Nadim	m
Nadir	m
Nadira	f
Nadiyya	f
Nadra	f
Nadya	f
Nagi	m
Nagib	m
Nail	m
Naila	f
Na'im	m
Na'ima	f
Naji	m
Najib	m
Najwa	f
Naseer	m
Nashwa	f
Nasib	m
Nasim	f
Nasir	m
Nasira	f
Nasser	m
Nawal	f
Nawra	f
Nazih	m
Nazli	f
Nima	mf
Nizar	m
Noor	mf
Nuha	f
Nur	mf
Nura	f
Omar	m
Osama	m
Qadir	m
Qamar	mf
Qasim	m
Qismat	m
Qusay	m
Rabab	f
Rabi	m
Rabi'a	f
Ra'd	m
Rafiq	m
Rafiqa	f
Rahat	mf
Raheem	m
Rahim	m
Rais	m
Raisa (3)	f
Raja	f
Rajiya	f
Rajya	f
Rana	f
Randa	f
Raniya	f
Ranya	f
Rasha	f
Rashad	m
Rashed	m
Rasheed	m
Rashid	m
Rashida	f
Rasim	m
Rasima	f
Rasul	m
Rauf	m
Rawiya	f
Rawya	f
Raza	m
Riad	m
Riaz	m
Rida	m
Ridwan	m
Ridwana	f
Rim	f
Rizwan	m
Rizwana	f
Ruba	f
Ruh	m
Ruqayya	f
Rusul	m
Ruwa	f
Ruya	f
Sabah	f
Sabeen	f
Sabri	m
Sabriyya	m
Sa'd	m
Sadaf	f
Saddam	m
Sa'di	m
Sa'dia	f
Safi	m
Safiya	f
Safiyyah	f
Sa'id	m
Sa'ida	f
Saif	m
Saif Al Din	m
Saiful	m
Saifullah	m
Saira	f
Sajjad	m
Sakhr	m
Sakina	f
Salah	m
Salah Al Din	m
Saleem	m
Saleh	m
Salha	f
Salih	m
Saliha	f
Salil	m
Salim	m
Salima	f
Salma	f
Salman	m
Salwah	f
Samad	m
Samar	f
Sameer	m
Sameera	f
Sami	m
Samia	f
Samina	f
Samir	m
Samira	f
Samiya	f
Sana	f
Sani	m
Saniyya	f
Sanya	f
Sayyid	m
Sayyida	f
Selima	f
Shad	m
Shadi	m
Shadiya	f
Shadya	f
Shafaqat	mf
Shafiq	m
Shafiqa	f
Shahira	f
Shakeel	m
Shakil	m
Shakila	f
Shakir	m
Shakira	f
Sham'a	f
Shareef	m
Shariah	m
Sharif	m
Sharifa	f
Shazi	f
Shihab	m
Shukri	m
Shukriya	f
Shukriyya	f
Shula	f
Soraya	f
Suha	f
Suhail	m
Suhayl	m
Sulaiman	m
Sulayman	m
Sultan	m
Sultana	f
Sumayya	f
Suraya	f
Surayya	f
Tabassum	mf
Tahir	m
Tahira	f
Tahmid	m
Taliba	f
Tamid	m
Tarek	m
Tariq	m
Tasnim	f
Tawfiq	m
Thamina	f
Thana	f
Thurayya	f
Tufayl	m
Umar	m
Usama	m
Usman	m
Uthman	m
Uzma	f
Wafai	m
Wafi	m
Wafiya	f
Waheed	m
Waheeda	f
Wahid	m
Wahida	f
Walid	m
Waqar	m
Wasi	m
Wasim	m
Wassim	m
Widad	f
Yaqub	m
Yasir	m
Yasser	m
Yousef	m
Youssef	m
Yusef	m
Yushua	m
Yusra	f
Zaahir	m
Zaahir	m
Zaahira	f
Zahi	m
Zahia	f
Zahid	m
Zahida	f
Zahir	m
Zahira	f
Zahra	f
Zahrah	f
Zaid	m
Zaida	f
Zain	m
Zaina	f
Zainab	f
Zaira	f
Zaki	m
Zakiyya	f
Zaman	m
Zaray	f
Zayd	m
Zayn	m
Zayna	f
Zaynab	f
Zia	m
Ziad	m
Ziya	m
Ziyad	m
Zubaida	f
Zulaykha	f
Zulekha	f
Zulfaqar	m
Zulfikar	m
Zulfiqar	m
Laila	f
Layla	f
Leila	f
Aaliyah	f
Leyla	f
Ebrahim	m
Esmail	m
Firdaus	m
Sahar	f
Aida	f
Ahmed	m
Musa	m
Yahya	m
Yunus	m
Yusuf	m
Adam	m
Sarah	f
Sara	f
Binyamin	m
Bahadur	m
Firuz	m
Gulzar	mf
Javed	m
Mirza	m
Naveed	m
Navid	m
Shahnaz	f
Shahrazad	f
Shahrizad	f
Shahzad	m
Yasmeen	f
Yasmin	f
Yasmine	f
