Abene	f
Agurne	f
Agurtzane	f
Aingeru	m
Ainhoa	f
Aintza	f
Aintzane	f
Aitor	m
Alaia	f
Alazne	f
Alesander	m
Amaia	f
Amets	mf
Ander	m
Andoni	m
Antton	m
Arantxa	f
Arantzazu	f
Argi	m
Argider	m
Argiñe	f
Arkaitz	m
Arrats	m
Bakar	m
Bakarne	f
Balendin	m
Basajaun	m
Beñat	m
Berezi	f
Bidane	f
Bihotz	f
Bikendi	m
Bittor	m
Danel	m
Eder	m
Ederne	f
Edorta	m
Edur	m
Edurne	f
Eguzki	m
Eguzkiñe	f
Eider	f
Ekain	m
Ekaitz	m
Elixabete	f
Endika	m
Eneko	m
Erlantz	m
Erlea	f
Erramun	m
Eskarne	f
Estebe	m
Esti	f
Estiñne	f
Eukene	f
Euria	f
Eztebe	m
Frantziska	f
Frantzisko	m
Gaizka	m
Ganix	m
Garaile	m
Garbi	f
Garbiñe	f
Garden	f
Goizane	f
Goizargi	f
Goizeder	f
Gorka	m
Gotzon	m
Gotzone	f
Gurutz	m
Gurutze	f
Gutxi	m
Haizea	f
Harkaitz	m
Hilargi	f
Hirune	f
Hodei	m
Igon	m
Igone	f
Ihintza	f
Iker	m
Imanol	m
Iñaki	m
Irati	f
Irune	f
Itsasne	f
Itsaso	f
Itxaro	f
Itxaso	f
Itzal	m
Izar	f
Izotz	m
Jakes	m
Jokin	m
Jone	f
Joseba	m
Josepe	m
Josu	m
Josune	f
Julen	m
Kattalin	f
Kemen	m
Kepa	m
Kerman	m
Kistiñe	f
Koldo	m
Koldobika	m
Lore	f
Lorea	f
Luken	m
Maia (3)	f
Maialen	f
Maite	f
Markel	m
Martzel	m
Matia	m
Mattin	m
Matxin	m
Mikel	m
Miren	f
Mitxel	m
Nagore	f
Nahia	f
Naiara	f
Nayara	f
Nekane	f
Nere	f
Nerea	f
Oihana	f
Oroitz	m
Ortzi	m
Osane	f
Patxi	m
Peio	m
Peru	m
Sendoa	m
Sorne	f
Terese	f
Txomin	m
Udane	f
Unai	m
Usoa	f
Uxue	f
Xanti	m
Ximun	m
Zeru	m
Zigor	m
Zorion	mf
Zorione	f
Zuriñe	f
Zuzen	m
Xabier	m
Ion	m
Amaya	f
Itziar	f
Anne	f
Katalin	f
Maria	mf
Jon	m
Nikola	m
Marko	m
