Marcus	m
Asaf	m
Azaria	m
Bashemath	f
Chenaniah	m
Cleophas	m
Eliphalet	m
Ezar	m
Habacuc	m
Hepzibah	f
Hulda	f
Jahel	f
Jephtha	m
Jescha	f
Josias	m
Kezia	f
Mahalah	m
Mahali	m
Mehitabel	f
Micajah	m
Oshea	m
Phineas	m
Salathiel	m
Susannah	f
Temani	m
Terach	m
Timeus	m
Zebulon	m
Zelpha	f
Enos	m
Manasses	m
Orpha	f
Rebekah	f
Jonas	m
Jeremy	m
Nathaniel	m
Phebe	f
Zachariah	m
Candace	f
Thaddeus	m
Elisabeth	f
Efraim	m
Noa	f
