Archelaus	m
Dionysius	m
Timaeus	m
Timon	m
Artaxerxes	m
Belshazzar	m
Agrippa	mf
Festus	m
Pontius	m
Lucius	m
Titus	m
Rufus	m
Cornelius	m
Ararat	m
Abaddon	m
Abednego	m
Abiah	mf
Abiel	m
Abihu	m
Abijah	mf
Abilene	f
Abimael	m
Abimelech	m
Abiram	m
Abishag	f
Abishai	m
Abital	f
Abram	m
Achan	m
Achim	m
Adah	f
Adalia	m
Adino	m
Adonijah	m
Adoniram	m
Ahab	m
Allon	m
Alvah	m
Amal	m
Amariah	m
Ami	m
Amittai	m
Ammiel	m
Anah	mf
Anan	m
Anani	m
Apphia	f
Areli	m
Aretas	m
Aridai	m
Asenath	f
Azarel	m
Azariah	m
Azazel	m
Azaziah	m
Azel	m
Azriel	m
Azubah	f
Bathsheba	f
Beelzebub	m
Benaiah	m
Bethel	f
Bethuel	m
Bilhah	f
Bithiah	f
Caiaphas	m
Canaan	m
Carmi	m
Clopas	m
Dathan	m
Delaiah	m
Dorcas	f
Ebenezer	m
Eder	m
Edna	f
Edom	m
Elam	m
Eldad	m
Eliakim	m
Elioenai	m
Eliphelet	m
Eliud	m
Elnathan	m
Elon	m
Eran	m
Gad	m
Gamaliel	m
Gedaliah	m
Gemariah	m
Gera	m
Gershom	m
Gershon	m
Gethsemane	f
Gilead	m
Goliath	m
Gomer	mf
Habakkuk	m
Hagar	f
Haggai	m
Ham	m
Hanan	m
Hananiah	m
Havilah	mf
Hazael	m
Heber	m
Helah	f
Hephzibah	f
Herod	m
Herodion	m
Hezekiah	m
Hirah	m
Hizkiah	m
Hosanna	mf
Hosea	m
Hoshea	m
Huldah	f
Huri	m
Ichabod	m
Isaias	m
Iscah	f
Ishmael	m
Ishmerai	m
Ishvi	m
Issachar	m
Ithai	m
Ithiel	m
Ivah	f
Jaala	m
Jaasau	m
Jabez	m
Jabin	m
Jachin	m
Jada	m
Jadon	m
Jael	f
Jahleel	m
Jahzeel	m
Jair	m
Jairus	m
Jamin	m
Japheth	m
Javan	m
Jedidah	f
Jedidiah	m
Jehiel	m
Jehoash	m
Jehoiachin	m
Jehoiakim	m
Jehonathan	m
Jehoram	m
Jehoshaphat	m
Jehu	m
Jehudi	m
Jephthah	m
Jeremiel	m
Jeriah	m
Jericho	m
Jerusha	f
Jethro	m
Jezebel	f
Joab	m
Joash	m
Jochebed	f
Joktan	m
Joram	m
Joses	m
Jotham	m
Jubal	m
Judah	m
Judas	m
Kenan	m
Kenaniah	m
Keren Happuch	f
Keturah	f
Keziah	f
Laban	m
Lael	m
Lamech	m
Madai	m
Mahalath	f
Mahlah	mf
Mahli	m
Manasseh	m
Mara	f
Mattaniah	m
Matthan	m
Medad	m
Mehetabel	f
Merab	f
Merari	m
Meshach	m
Methuselah	m
Micaiah	mf
Moab	m
Nadab	m
Nahor	m
Nahum	m
Naphtali	m
Nehemiah	m
Nekoda	m
Nethaniah	m
Nimrod	m
Noah	f
Obadiah	m
Obed	m
Oded	m
Ohad	m
Omar	m
Ophir	m
Ophrah	m
Orpah	f
Othniel	m
Pallu	m
Peninnah	f
Persis	f
Philadelphia	f
Philemon	m
Philetus	m
Phinehas	m
Rahab	f
Ram	m
Rehoboam	m
Reuel	m
Sapphira	f
Sarai	f
Sela	f
Selah	f
Shadrach	m
Shamgar	m
Sharar	m
Shealtiel	m
Sheba	m
Shelah	m
Shem	m
Shemer	m
Sherah	f
Shiloh	mf
Talitha	f
Tarah	f
Tekoa	m
Teman	m
Terah	m
Thaddaeus	m
Tiras	m
Tirzah	f
Tobiah	m
Tryphena	f
Uriah	m
Uzziah	m
Vashti	f
Zacchaeus	m
Zadok	m
Zalmon	m
Zebadiah	m
Zebedee	m
Zebulun	m
Zedekiah	m
Zephaniah	m
Zibiah	f
Zillah	f
Zilpah	f
Zimri	m
Zuriel	m
Mnason	m
Tryphosa	f
Achaicus	m
Nicodemus	m
Prochorus	m
Theophilus	m
Epaphras	m
Aquila	mf
Junia	f
Drusilla	f
Prisca	f
Damaris	f
Esdras	m
Kandake	f
Nathanael	m
Zacharias	m
Syntyche	f
Adlai	m
Anaiah	m
Asaph	m
Avital	f
Dan	m
Elisha	m
Elisheba	f
Elkanah	m
Enosh	m
Ezer	m
Mattan	m
Neriah	m
Nethanel	m
Seraiah	m
Delilah	f
Absalom	m
Alphaeus	m
Ananias	m
Annas	m
Basemath	f
Basmath	f
Cain	m
Cainan	m
Carpus	m
Cephas	m
Cleopas	m
Erastus	m
Eutychus	m
Heli	m
Lazarus	m
Onesimus	m
Onesiphorus	m
Abidan	m
Anath	m
Eleazar	m
Enoch	m
Ephrath	f
Esau	m
Amram	m
Simeon	m
Job	m
Beulah	f
Ezekiel	m
Hiram	m
Jemima	f
Josiah	m
Micah	m
Rhoda	f
Seth	m
Solomon	m
Zechariah	m
Elihu	m
Eden	f
Moriah	f
Eunice	f
Dinah	f
Samson	m
Ezra	m
Gideon	m
Ira	m
Amos	m
Emmanuel	m
Tobias	m
Adina	mf
Barak	m
Baruch	m
Boaz	m
Hadassah	f
Hillel	m
Ithamar	m
Melech	m
Menahem	m
Meshullam	m
Michal	f
Mordecai	m
Naamah	f
Omri	m
Shiphrah	f
Uri	m
Uriel	m
Zipporah	f
Saul	m
Ephraim	m
Arieh	m
Asa	m
Atarah	f
Ehud	m
Nogah	mf
Uzzi	m
Uzziel	m
Eliezer	m
Malachi	m
Reuben	m
Asher	m
Levi	m
Ariel	mf
Belial	m
Lehi	m
Lemuel	m
Ashtoreth	f
Urban	m
Andrew	m
Bartholomew	m
Bethany	f
Caleb	m
Elizabeth	f
James	m
Jared	m
Jeremiah	m
Joel	m
John	m
Jonah	m
Jordan	mf
Joshua	m
Jude	m
Lois	f
Luke	m
Mary	f
Matthew	m
Noah	m
Sharon	f
Stephen	m
Timothy	m
Tabitha	f
Abner	m
Bernice	f
Carmel	f
Moses	m
Cyrus	m
Aaron	m
Chloe	f
Jesse	m
Jacob	m
Eve	f
Nathan	m
Joseph	m
Benjamin	m
Adam	m
Thomas	m
Paul	m
Sarah	f
Jason	m
Simon	m
Esther	f
Abel	m
Samuel	m
Salome	f
Abigail	f
Lydia	f
Michael	m
Claudia	f
Alexander	m
Peter	m
Ruth	f
Jonathan	m
Julia	f
Phoebe	f
Silas	m
Isaiah	m
Isaac	m
Ethan	m
Judith	f
Deborah	f
Elijah	m
Naomi	f
Eli	m
Leah	f
Abraham	m
Hannah	f
Rachel	f
Daniel	m
David	m
Anna	f
Rebecca	f
Darius	m
Joanna	f
Mark	m
Philip	m
Martha	f
Gabriel	m
Magdalene	f
Felix	m
Barnabas	m
Raphael	m
Immanuel	m
Narcissus	m
Nereus	m
Matthias	m
Israel	m
Shulammite	f
Zion	m
Diklah	mf
Tamar	f
Miriam	f
Susanna	f
Silvanus	m
Jesus	m
Satan	m
