Simeon	m
Albena	f
Andon	m
Apostol	m
Asen	m
Atanas	m
Bilyana	f
Bogomil	m
Bojidar	m
Boyana	f
Boyka	f
Boyko	m
Bozhidar	m
Chavdar	m
Damyan	m
Dana (3)	f
Danail	m
Desislav	m
Desislava	f
Dessislava	f
Deyan	m
Donka	f
Elisaveta	f
Emiliya	f
Gavrail	m
Georgi	m
Gergana	f
Hristina	f
Hristo	m
Iliya	m
Iordan	m
Ivailo	m
Ivaylo	m
Ivet	f
Kalina	f
Kaloyan	m
Kamen	m
Kosta	m
Kostadin	m
Krasimir	m
Krasimira	f
Krastio	m
Krastyo	m
Krastyu	m
Lala	f
Lilyana	f
Luben	m
Lyuben	m
Lyubomir	m
Lyudmil	m
Milen	m
Momchil	m
Nedelcho	m
Nedelya	f
Nikolina	f
Ognian	m
Ognyan	m
Penka	f
Penko	m
Plamen	m
Raina	f
Raya	f
Rayko	m
Rayna	f
Rayno	m
Rosa	f
Rositsa	f
Silviya	f
Spas	m
Stoyan	m
Stoyanka	f
Timotei	m
Todorka	f
Tsveta	f
Tsvetan	m
Tsvetanka	f
Valko	m
Vasilka	f
Yan	m
Yanko	m
Yasen	m
Yavor	m
Yoan	m
Yoana	f
Yordan	m
Yordana	f
Yordanka	f
Yosif	m
Zahari	m
Zaharina	f
Zara	f
Zhelyazko	m
Radko	m
Tereza	f
Bisera	f
Dimitar	m
Grozda	f
Grozdan	m
Grozdana	f
Iskra	f
Kiril	m
Nevena	f
Vasil	m
Zhivka	f
Zhivko	m
Aleksandar	m
Ekaterina	f
Mira	f
Gavril	m
Evdokiya	f
Evgeni	m
Evgeniya	f
Yana	f
Stanimir	m
Boris	m
Todor	m
Ivo	m
Silva	f
Toma	m
Mladen	m
Zdravko	m
Radka	f
Radoslava	f
Iva	f
Milena	f
Milan	m
Mila	f
Radoslav	m
Ivana	f
Darina	f
Zora	f
Miroslav	m
Stanislava	f
Stanislav	m
Ivanka	f
Angel	mf
Linda	f
Martin	m
Anna	f
Magdalena	f
Konstantin	m
Anton	m
Emil	m
Stefan	m
Petra	f
Yakov	m
Elena	f
Eva	f
Marina	f
Teodora	f
Katerina	f
Ilija	m
Anka	f
Bogdan	m
Bogdana	f
Ioana	f
Mihail	m
Violeta	f
Andrei	m
Ioan	m
Aleksandrina	f
Andrey	m
Galina	f
Kliment	m
Lidiya	f
Lyudmila	f
Mikhail	m
Nadejda	f
Nadezhda	f
Naum	m
Nikolai	m
Petia	mf
Petya	mf
Polina	f
Rada	f
Samuil	m
Sergei	m
Sergej	m
Sergey	m
Yulian	m
Yuliana	f
Yuliya	f
Zhenya	mf
Ludmilla	f
Snezhana	f
Irina	f
Ilia	m
Nikifor	m
Borislav	m
Borislava	f
Lazar	m
Lyubov	f
Viktoriya	f
Ivan	m
Pavel	m
Veronika	f
Vladislav	m
Varvara	f
Aleksandra	f
Olga	f
Vladimir	m
Tatiana	f
Svetlana	f
Roza	f
Anastasiya	f
Liliya	f
Mariya	f
Filip	m
Valentin	m
Viktor	m
Teodor	m
Kristina	f
Sava	m
Petar	m
Dragomir	m
Nikola	m
Dragan	m
Radomir	m
Stanka	f
Stanko	m
Marta	f
Ana	f
Anastas	m
Margarita	f
Marko	m
Grigor	m
