Ah	mf
Ai	f
Bai	mf
Bao	mf
Bo	mf
Chang	mf
Chao	m
Chen	mf
Cheng	mf
Chin	mf
Chun	mf
Da	m
Fen	f
Fu	mf
Gang	m
Guo	mf
Hai	mf
He	mf
Heng	mf
Hong	m
Hua	mf
Huan	mf
Huang	m
Hui	f
Jia	mf
Jian	mf
Jiang	mf
Jin	mf
Jing	mf
Ju	f
Jun	mf
Kun	mf
Li	mf
Lim	mf
Lin	mf
Ling	mf
Mei	f
Min	mf
Ming	mf
Mu	mf
Ning	mf
Nuan	f
Nuo	f
Ping	mf
Qing	mf
Qiu	mf
Rong	mf
Ru	mf
Shi	mf
Shu	f
Shui	mf
Shun	mf
Su	mf
Tai	mf
Tu	mf
Wen	mf
Wu	mf
Xiang	mf
Xiu	f
Xue	mf
Xun	mf
Ya	f
Yi	mf
Yin	f
Yu	mf
Yun	mf
Zan	mf
Zhen	f
Zheng	mf
Zhi	mf
Zhong	mf
Zhou	mf
Dong	m
Yong	mf
Lan	f
