arius	m
Abelone	f
Agnete	f
Agnethe	f
Alberte	f
Alvilda	f
Ane	f
Annelise	f
Asger	m
Asløg	f
Bendt	m
Bent	m
Bente	f
Bine	f
Birgitte	f
Birte	f
Birthe	f
Bjarke	m
Caja	f
Cille	f
Ditte	f
Dorete	f
Dorit	f
Dorte	f
Dorthe	f
Eluf	m
Flemming	m
Frederikke	f
Hagen	m
Helle	f
Ib	m
Jannick	m
Jannik	m
Jeppe	m
Jerrik	m
Jesper	m
Jokum	m
Jørn	m
Jytte	f
Keld	m
Kirstine	f
Kjeld	m
Knud	m
Kresten	m
Lærke	f
Laurits	m
Lauritz	m
Lone	f
Lykke	f
Mads	m
Magdalone	f
Maren	f
Marna	f
Merete	f
Mogens	m
Niels	m
Oluf	m
Palle	m
Poul	m
Preben	m
Rikke	f
Sille	f
Solvej	f
Steen	m
Svend	m
Tarben	m
Trine	f
Troels	m
Tue	m
Tyge	m
Uffe	m
Vilfred	m
Vita	f
Frederik	m
Malthe	m
Thorben	m
Torben	m
Åge	m
Aksel	m
Benedikte	f
Christen	m
Esben	m
Frode	m
Gregers	m
Grethe	f
Haldor	m
Halldor	m
Hjørdis	f
Janne	f
Jørg	m
Jørgen	m
Kristen	m
Lovise	f
Maiken	f
Malene	f
Margrethe	f
Mette	f
Morten	m
Ole	m
Peder	m
Pernille	f
Søren	m
Stine	f
Torbjørn	m
Vibeke	f
Kirsten	f
Else	f
Hanne	f
Karen	f
Johanne	f
Nikolaj	m
Elva	f
Majken	f
Jonna	f
Frej	m
Freja	f
Malte	m
Urban	m
Kris	mf
Vincent	m
Virginia	f
Henriette	f
Mathilde	f
Agathe	f
Claus	m
Klaus	m
Liselotte	f
Margarethe	f
Ulrike	f
Sofie	f
Christa	f
Magdalene	f
Grete	f
Henning	m
Karoline	f
Lene	f
Steffen	m
Klemens	m
Anika	f
Lotte	f
Stefanie	f
Rebekka	f
Dorothea	f
Asbjørn	m
Åsmund	m
Bjørn	m
Dagfinn	m
Erlend	m
Espen	m
Gry	f
Gudbrand	m
Gulbrand	m
Halvor	m
Hege	f
Ingebjørg	f
Olav	m
Silje	f
Tine	f
Cecilie	f
Jacobine	f
Olaf	m
Bo	m
Christer	m
Erland	m
Thorsten	m
Torsten	m
