Aberash	f
Achieng	f
Adhiambo	f
Akinyi	f
Asha	f
Atieno	f
Awiti	f
Babirye	f
Chausiku	f
Chiumbo	m
Desta	mf
Eshe	f
Faraji	m
Furaha	f
Gwandoya	m
Imamu	m
Imani	f
Isingoma	m
Jelani	m
Jengo	m
Jumaane	m
Kamaria	f
Kato	m
Khamisi	m
Kibwe	m
Kirabo	mf
Makena	mf
Marjani	f
Mchumba	f
Mirembe	f
Mosi	m
Mwanajuma	f
Mwenye	m
Nakato	f
Nia	f
Nuru	f
Nyah	f
Ochieng	m
Odhiambo	m
Otieno	m
Ramla	f
Sanaa	f
Sauda	f
Sefu	m
Simba	m
Ssanyu	f
Subira	f
Tafari	m
Tendaji	m
Wasswa	m
Wekesa	m
Worknesh	f
Zuberi	m
Zuri	f
