Aaliyah	f
Leyla	f
Eden	f
Moriah	f
Xander	m
Abigayle	f
Aden	m
Aiden	m
Alaina	f
Alayna	f
Alesha	f
Alexandrea	f
Alexus	f
Alivia	f
Alysa	f
Alyse	f
Alysha	f
Alyssia	f
Anjelica	f
Ansley	f
Ariana	f
Aryana	f
Ashlea	f
Ashlee	f
Ashleigh	f
Ashlie	f
Ashlyn	f
Ashlynn	f
Asia	f
Aspen	f
Aubree	f
Aubrie	f
Austen	m
Austyn	m
Aydan	m
Ayden	m
Bailee	f
Baylee	f
Becci	f
Bekki	f
Blaze	m
Caden	m
Cadence	f
Cailyn	f
Caitlyn	f
Caleigh	f
Camden	m
Camron	m
Camryn	f
Carley	f
Cassidy	mf
Chanelle	f
Channing	mf
Chanté	f
Charlize	f
Chelsey	f
Chelsie	f
Cheyanne	f
China	f
Chyna	f
Ciera	f
Cierra	f
Codie	m
Colten	m
Colton	m
Conner	m
Coty	m
Cristen	f
Cydney	f
Dahlia	f
Dakota	mf
Danika	f
Darion	m
Deacon	m
Deion	m
Delaney	f
Denzel	m
Desirae	f
Destinee	f
Devan	mf
Deven	m
Devyn	mf
Diamond	f
Elle	f
Emely	f
Emerald	f
Emilee	f
Erykah	f
Eryn	f
Essence	f
Fallon	f
Gage	m
Genesis	f
Gisselle	f
Grayson	m
Greyson	m
Hailee	f
Hailey	f
Hailie	f
Haleigh	f
Haley	f
Halle	f
Haylee	f
Hayleigh	f
Hayley	f
Haylie	f
Heaven	f
Holden	m
Ireland	f
Izabelle	f
Jaden	mf
Jadyn	mf
Jaida	f
Jaiden	mf
Janae	f
Janessa	f
Jaqueline	f
Jaron	m
Jasmyn	f
Jaxon	m
Jayda	f
Jayde	f
Jayden	mf
Jaydon	m
Jayla	f
Jaylee	f
Jaylen	m
Jaylin	mf
Jaylon	m
Jaylyn	f
Jaymes	m
Jazlyn	f
Jazmin	f
Jazmine	f
Jazmyn	f
Jeni	f
Jessi	f
Jett	m
Joi	f
Jordyn	f
Jorja	f
Joselyn	f
Kacey	f
Kacie	f
Kade	m
Kaden	m
Kailee	f
Kailey	f
Kailyn	f
Kaitlin	f
Kaitlyn	f
Kaitlynn	f
Kaleb	m
Kaleigh	f
Kaley	f
Kalie	f
Kalyn	f
Kam	m
Kameron	m
Kamryn	f
Kandace	f
Karlee	f
Karly	f
Kassidy	f
Kassy	f
Katelin	f
Katelyn	f
Katelynn	f
Katlyn	f
Kaycee	f
Kaylee	f
Kayleigh	f
Kayley	f
Kaylie	f
Kaylin	f
Kaylyn	f
Kaylynn	f
Keanna	f
Keara	f
Keaton	m
Keeley	f
Keila	f
Keira	f
Kelsi	f
Kelsie	f
Khloe	f
Kian	m
Kiara	f
Kiarra	f
Kiefer	m
Kierra	f
Kiersten	f
Kody	m
Kolby	m
Kole	m
Konnor	m
Korbin	m
Kortney	f
Kourtney	f
Krysten	f
Krystina	f
Krystle	f
Kyleigh	f
Kyler	m
Lainey	f
Lauryn	f
Leandra	f
Lesly	f
Linsey	f
London	mf
Lyndsay	f
Lyndsey	f
Lynsey	f
Lyric	f
Macey	f
Maddison	f
Maddox	m
Madisyn	f
Madyson	f
Maegan	f
Makayla	f
Makenna	f
Makenzie	f
Malakai	m
Maleah	f
Mallory	f
Marlee	f
Marley	f
Mckayla	f
Mckenna	f
Mckenzie	f
Meadow	f
Melany	f
Mikayla	f
Miley	f
Miracle	f
Montana	mf
Mya	f
Myranda	f
Nash	m
Natalee	f
Nevaeh	f
Paisley	f
Paxton	m
Payton	mf
Phoenix	mf
Piper	f
Porsche	f
Precious	f
Princess	f
Reanna	f
Reilly	mf
Rhianna	f
Rikki	f
River	m
Ryann	f
Ryder	m
Ryker	m
Rylan	m
Rylee	f
Ryley	m
Rylie	f
Sable	f
Sage	mf
Salena	f
Samara	f
Sarina	f
Savanna	f
Sawyer	m
Scarlet	f
Serenity	f
Shae	f
Shanae	f
Shanelle	f
Shania	f
Shannen	f
Shaquille	m
Shawnee	f
Shena	f
Shyla	f
Siena	f
Sienna	f
Sierra	f
Sky	f
Skye	f
Skylar	mf
Skyler	mf
Slade	m
Sommer	f
Stephani	f
Storm	m
Sydnie	f
Talon	m
Tamia	f
Tarah	f
Tatianna	f
Tatum	f
Tatyanna	f
Tawny	f
Tayla	f
Tayler	mf
Teagan	mf
Tianna	f
Tiara	f
Treasure	f
Tristen	m
Tristin	m
Triston	m
Tucker	m
Tylor	m
Tyrell	m
Unique	f
Willow	f
Winter	f
Xzavier	m
Yazmin	f
Zander	m
Zara	f
Zaria	f
Zavier	m
Zoey	f
Zoie	f
Alexia	f
Alannah	f
Kasandra	f
Kendal	mf
Giselle	f
Jessika	f
Kassandra	f
Yasmin	f
Yasmine	f
Finnegan	m
Kegan	m
Rowan	mf
Connor	m
Aidan	m
Annabella	f
Ainsley	mf
Annika	f
Gwyneth	f
