Antwan	m
Deandre	m
Deangelo	m
Dedrick	m
Deshaun	m
Deshawn	m
Ivory	mf
Jamar	m
Keisha	f
Kenya	f
Keshia	f
Kiana	f
Kisha	f
Ladonna	f
Lakeisha	f
Lakeshia	f
Lakisha	f
Lashawn	mf
Lashonda	f
Latanya	f
Latasha	f
Latisha	f
Latonya	f
Latoya	f
Lawanda	f
Marquis	m
Marquita	f
Tanesha	f
Tanika	f
Tanisha	f
Tisha	f
