Charis	f
Aaren	mf
Abegail	f
Acacia	f
Adair	m
Adamina	f
Ainslee	f
Ainslie	f
Alanis	f
Alannis	f
Aldous	m
Alea	f
Aleesha	f
Alexandrina	f
Algar	m
Aliah	f
Alise	f
Alishia	f
Alisia	f
Alisya	f
Allana	f
Allannah	f
Allegria	f
Allissa	f
Allycia	f
Alphonzo	m
Alyx	f
Amabel	f
Ambrosine	f
Amery	m
Amethyst	f
Amias	m
Amilia	f
Amity	f
Amyas	m
Andriana	f
Andrina	f
Anemone	f
Angelle	f
Anima	f
Anise	f
Annabeth	f
Annalee	f
Anneka	f
Annora	f
Araminta	f
Ariella	f
Arin	f
Aston	mf
Astor	m
Astra	f
Auberon	m
Audrea	f
Aureole	f
Avaline	f
Avalon	f
Aveline	f
Averill	mf
Avice	f
Aylmer	m
Azalea	f
Azura	f
Azure	f
Balfour	m
Barret	m
Beaumont	m
Beauregard	m
Berry	f
Bethanie	f
Bethney	f
Betony	f
Bevis	m
Biff	m
Blondie	f
Blythe	m
Caelan	mf
Caelie	f
Caetlin	f
Caileigh	f
Cailin	f
Cairo	m
Calanthe	f
Calanthia	f
Calleigh	f
Callista	f
Camellia	f
Caprice	f
Capricia	f
Careen	f
Caris	f
Carlisa	f
Carran	m
Carreen	f
Carver	m
Cassarah	f
Cate	f
Catherin	f
Cayley	f
Ceara	f
Cearra	f
Cedar	f
Celandine	f
Celinda	f
Chalice	f
Charisma	f
Charmian	f
Charnette	f
Cherette	f
Cherice	f
Cherokee	mf
Chile	m
Christabel	f
Christabella	f
Christabelle	f
Christianne	f
Christmas	mf
Chrysanta	f
Cindra	f
Clarette	f
Clarity	f
Clematis	f
Clemency	f
Cletis	m
Clover	f
Colene	f
Collyn	f
Columbine	f
Comfort	f
Connell	m
Coreen	f
Coriander	f
Corynn	f
Cree	m
Creighton	m
Crispin	m
Crofton	m
Cuthbert	m
Cyan	f
Cybill	f
Cymone	f
Cyrilla	f
Dacre	m
Daffodil	f
Darcey	f
Darden	m
Dashiell	m
Davena	f
Davida	f
Davinia	f
Deemer	m
Deforrest	m
Deitra	f
Delice	f
Delicia	f
Delight	f
Delroy	m
Dene	m
Denholm	m
Deniece	f
Deonne	f
Derby	m
Derren	m
Derryl	m
Deryck	m
Detta	f
Devereux	m
Deziree	f
Diantha	f
Digby	m
Diggory	m
Divina	f
Donelle	f
Doria	f
Drina	f
Driskoll	m
Drummond	m
Duana	f
Dunstan	m
Dyson	m
Earleen	f
Edric	m
Edweena	f
Edwena	f
Edwyn	m
Edwyna	f
Edytha	f
Eglantine	f
Eleonor	f
Elfrida	f
Elicia	f
Eliott	m
Elsabeth	f
Elsdon	m
Elyzabeth	f
Emalee	f
Emmerson	m
Epiphany	f
Esmaralda	f
Esmond	m
Esmund	m
Eustacia	f
Eveleen	f
Everard	m
Everitt	m
Faithe	f
Fancy	f
Farley	m
Farran	m
Fitz	m
Fitzroy	m
Flanagan	m
Flannery	mf
Floella	f
Flower	f
Flynn	m
Fortune	f
Fox	m
Francene	f
Gae	f
Gaenor	f
Gaila	f
Gardenia	f
Garnette	f
Gayelord	m
Geena	f
Geffrey	m
Genette	f
Gerrard	m
Gervase	m
Giffard	m
Gladwin	m
Gladwyn	m
Glanville	m
Gloriana	f
Glory	f
Goddard	m
Goodwin	m
Gore	m
Gosse	m
Grenville	m
Gresham	m
Grey	m
Grier	m
Grosvenor	m
Guendolen	f
Gwenevere	f
Gyles	m
Gypsy	f
Hadyn	m
Hallam	m
Hammond	m
Happy	mf
Harmonie	f
Harrietta	f
Haydee	f
Haze	f
Headley	m
Hedley	m
Hepsie	f
Hewie	m
Honey	f
Honor	f
Honour	f
Humphry	m
Hyacinth	f
Hylda	f
Hyram	m
Idelle	f
Ilbert	m
Ilean	f
Ileen	f
Indigo	mf
Inigo	m
Isador	m
Isbel	f
Isebella	f
Ivonette	f
Jacinda	f
Jacinth	f
Jackalyn	f
Jae	m
Jaki	f
Jakki	f
Jamaar	m
Jancis	f
Janeka	f
Janele	f
Janella	f
Janetta	f
Jannah	f
Jannine	f
Jaquelyn	f
Jaslyn	f
Jaycob	m
Jayma	f
Jayna	f
Jenae	f
Jenessa	f
Jennica	f
Jepson	m
Jerrard	m
Jerred	m
Jervis	m
Jessalyn	f
Jessamine	f
Jessamyn	f
Joandra	f
Jobeth	f
Joby	m
Jocelin	f
Jodene	f
Johna	f
Joisse	f
Jolyon	m
Jonelle	f
Jonette	f
Jonquil	f
Jordana	f
Joscelin	f
Josceline	f
Josephina	f
Josslyn	f
July	f
Julyan	m
Juniper	f
Kae	f
Kaelea	f
Kaelee	f
Kaety	f
Kalla	f
Kalysta	f
Karaugh	f
Karena	f
Karenza	f
Karyna	f
Kassia	f
Katee	f
Katheryne	f
Katriona	f
Kayleah	f
Kayleen	f
Kayly	f
Keeleigh	f
Keighley	f
Keiran	m
Kelcey	mf
Kelia	f
Kelleigh	f
Kemp	m
Kenelm	m
Kenith	m
Kenrick	m
Kerena	f
Kerensa	f
Kerenza	f
Kestrel	f
Kevyn	mf
Kiaran	m
Kilie	f
Kimberleigh	f
Kimberlyn	f
Kimbra	f
Kingsley	m
Kipling	m
Kodey	m
Kolleen	f
Korrine	f
Kristeen	f
Kristel	f
Kristia	f
Krystelle	f
Krystine	f
Kym	f
Kynaston	m
Kyrsten	f
Laird	m
Lake	m
Lallie	f
Lally	f
Lanford	m
Langdon	m
Lark	f
Laryn	f
Lauraine	f
Laurelle	f
Laurena	f
Laurencia	f
Lauressa	f
Laurinda	f
Laurissa	f
Lavena	f
Lavender	f
Lavone	f
Leanora	f
Lecia	f
Leilah	f
Leith	m
Lemoine	m
Lennard	m
Leontyne	f
Leroi	m
Lesleigh	f
Lewin	m
Leyton	m
Lianne	f
Lilac	f
Lindon	m
Lindsie	f
Linford	m
Linnaea	f
Linnet	f
Linnette	f
Linsay	f
Linzi	f
Lolicia	f
Lorainne	f
Lorelle	f
Lorn	m
Lorrin	m
Lotus	f
Lovel	m
Luanna	f
Lyall	m
Lyndi	f
Lyndsea	f
Lynna	f
Lynsay	f
Lynton	m
Lysette	f
Mabella	f
Madelaine	f
Madelina	f
Madoline	f
Maeghan	f
Maitland	m
Malandra	f
Malone	m
Mansel	m
Marcelyn	f
Maree	f
Mariabella	f
Marigold	f
Maris	f
Marlowe	m
Marly	f
Marvyn	m
Marylu	f
Maryvonne	f
Masterman	m
Maurene	f
Maxene	f
Maybelline	f
Maynerd	m
Mayson	m
Meade	mf
Melantha	f
Mellony	f
Melyssa	f
Mercia	f
Merideth	f
Meridith	f
Meriel	f
Merit	m
Meriwether	m
Merla	f
Merletta	f
Merrick	m
Merrilyn	f
Michayla	f
Michelyne	f
Midge	f
Mikhaila	f
Minta	f
Minty	f
Modesty	f
Monday	f
Montague	m
Mora	f
Mordikai	m
Morgana	f
Morley	m
Napier	m
Natille	f
Nevil	m
Neville	m
Nigella	f
Nikkole	f
Noelene	f
Nolene	f
Normina	f
Nowell	m
Ocean	mf
Odetta	f
Olyvia	f
Opaline	f
Oralee	f
Oralie	f
Orinda	f
Ormond	m
Ormonde	m
Orrell	m
Osbert	m
Osbourne	m
Osmond	m
Oswin	m
Ottoline	f
Pace	m
Pacey	m
Paden	m
Paget	f
Pamila	f
Panda	f
Parris	mf
Patton	m
Pauleen	f
Paulene	f
Peace	f
Pearce	m
Peers	m
Pene	f
Peony	f
Peregrine	m
Perlie	mf
Petrina	f
Petula	f
Petunia	f
Philipa	f
Philis	f
Phillida	f
Phillipa	f
Phyllida	f
Piety	f
Placid	m
Praise	f
Primrose	f
Primula	f
Prunella	f
Purdie	mf
Quin	m
Quincey	m
Quinlan	m
Rachyl	f
Radcliff	m
Radclyffe	m
Raeburn	m
Raelene	f
Raelyn	f
Rain	mf
Rainbow	f
Raine	f
Raschelle	f
Rastus	m
Ravenna	f
Raylene	f
Raymund	m
Read	m
Reannon	f
Rebeccah	f
Rebeccanne	f
Rebeckah	f
Redd	m
Reene	f
Reenie	f
Regana	f
Renie	f
Rexana	f
Rexanne	f
Reynard	m
Rheanna	f
Rhetta	f
Rica	f
Richardine	f
Richmal	f
Ridley	m
Rigby	m
Ripley	m
Robena	f
Robina	f
Robynne	f
Rolo	m
Rolph	m
Romayne	f
Romey	f
Ronnette	f
Rosabel	f
Rosaleen	f
Rosalin	f
Rosalynne	f
Rosamund	f
Rosannah	f
Rowanne	f
Rowina	f
Royale	m
Roydon	m
Royle	m
Royston	m
Rudyard	m
Ryana	f
Ryanne	f
Sabella	f
Sabryna	f
Sacheverell	m
Sachie	m
Saffron	f
Sammi	f
Sandford	m
Sandie	f
Sapphire	f
Saranna	f
Satchel	mf
Saxon	m
Scout	f
Seanna	f
Sefton	m
Selby	mf
Selwyn	m
September	mf
Sequoia	mf
Sera	f
Serrena	f
Shaelyn	f
Shanene	f
Shannah	f
Shantae	f
Shantelle	f
Shaquila	f
Sharalyn	f
Sharise	f
Sharmaine	f
Sharona	f
Shaw	m
Shaye	mf
Shaylyn	f
Sheard	m
Sheelagh	f
Sheenagh	f
Shelagh	f
Sherill	f
Sherisse	f
Sherley	f
Simonette	f
Sinclair	m
Sindy	f
Sinjin	m
Sloan	f
Sloane	f
Sonnie	m
Sophy	f
Sorrel	f
Sparrow	mf
Spike	m
Spirit	f
Stacee	f
Stirling	m
Sybella	f
Sydne	f
Sylvana	f
Symphony	f
Taegan	mf
Tahnee	f
Talbot	m
Tallulah	f
Tammara	f
Tamsen	f
Tamzen	f
Tansy	f
Tanzi	f
Tarina	f
Tatton	m
Tawnee	f
Tawnie	f
Teal	f
Teale	f
Tempest	f
Temple	mf
Tennyson	m
Thane	m
Thorburn	m
Thorley	m
Thurstan	m
Tiffiny	f
Tiger	m
Timotha	f
Tiphanie	f
Topaz	f
Topsy	f
Trafford	m
Tranter	m
Travers	m
Trecia	f
Tresha	f
Trevelyan	m
Trueman	m
Tylar	mf
Tyrrell	m
Ulric	m
Ulyssa	f
Unice	f
Unity	f
Upton	m
Ursella	f
Valary	f
Valda	f
Vianne	f
Vinal	m
Viviette	f
Vivyan	f
Wallis	mf
Warrick	m
Warwick	m
Wenda	f
Wenona	f
Wenonah	f
Whitaker	m
Wilfreda	f
Willoughby	m
Wilmot	m
Windsor	m
Winslow	m
Wisdom	mf
Wolfe	m
Wren	f
Wynne	m
Wynonna	f
Wynter	f
Wystan	m
Xanthia	f
Xavia	f
Xaviera	f
Xavior	m
Zavanna	f
Zavia	f
Zinnia	f
Zowie	f
Avila	f
Theobald	m
Rodolph	m
Katherina	f
Seraphina	f
Isolde	f
Driscoll	m
Eireann	f
Allegra	f
Dominica	f
Keitha	f
Dorita	f
Nidia	f
Nydia	f
Fleurette	f
Avril	f
Mirabelle	f
Philbert	m
Fleur	f
Boniface	m
Constant	m
Ginette	f
Josepha	f
Anselm	m
Barnabas	m
Alban	m
Humbert	m
Wolf	m
Ralf	m
Clancy	m
Daley	m
Daly	m
Gallagher	m
Keefe	m
Shevaun	f
Shevon	f
Barclay	m
Fraser	m
Graeme	m
Grahame	m
Greer	mf
Keir	m
Kerr	m
Lennon	m
Lennox	m
Lenox	m
Erskine	m
Isidora	f
