Elihu	m
Baldric	m
Barnaby	m
Christobel	f
Crispian	m
Dreda	f
Drogo	m
Dulcibella	f
Elfleda	f
Emmeline	f
Ermintrude	f
Ethelinda	f
Ethelred	m
Fulk	m
Fulke	m
Githa	f
Gytha	f
Hamnet	m
Hamo	m
Hamon	m
Idonea	f
Idony	f
Jem	m
Jemmy	m
Jep	m
Jeptha	m
Lettice	f
Melicent	f
Nigellus	m
Pancras	m
Parnel	f
Permelia	f
Pernel	f
Peronel	f
Petronel	f
Philander	m
Pleasance	f
Rayner	m
Sidony	f
Tacey	f
Temperance	f
Tetty	f
Thankful	f
Tolly	m
Verity	f
Moss	m
