Dion	m
Lucius	m
Titus	m
Cassius	m
Rufus	m
Marcus	m
Cornelius	m
Julius	m
Laila	f
Layla	f
Leila	f
Orpha	f
Rebekah	f
Delilah	f
Beulah	f
Ezekiel	m
Hiram	m
Jemima	f
Josiah	m
Micah	m
Rhoda	f
Seth	m
Solomon	m
Zechariah	m
Eunice	f
Dinah	f
Samson	m
Ezra	m
Gideon	m
Ira	m
Amos	m
Emmanuel	m
Tobias	m
Malachi	m
Reuben	m
Asher	m
Levi	m
Ariel	mf
Kirsten	f
Karen	f
Marleen	f
ZoÃ«	f
Dirk	m
Wilhelmina	f
Juliana	f
Janna	f
Abbey	f
Abbi	f
Abbie	f
Abby	f
Ace	m
Addie	f
Addison	mf
Addy	f
Adelaide	f
Adelle	f
Adolph	m
Adria	f
Adrianne	f
Aggie	f
Aisha	f
Al	m
Alana	f
Alanna	f
Alden	m
Alease	f
Alec	m
Alecia	f
Alene	f
Alesia	f
Aleta	f
Aletha	f
Alethea	f
Alexa	f
Alexandria	f
Alexina	f
Alf	m
Alfie	m
Alger	m
Algernon	m
Alisha	f
Alissa	f
Allie	f
Allison	f
Ally	f
Allyn	m
Allyson	f
Almira	f
Alpha	mf
Alphonso	m
Alton	m
Alva	m
Alvena	f
Alvin	m
Alvina	f
Alyce	f
Alycia	f
Alys	f
Alysia	f
Alyson	f
Alyssa	f
Ambrose	m
America	f
Ami	f
Amie	f
Amy	f
Anastacia	f
Anderson	m
Andi	f
Andie	mf
Andra	f
Andre	m
Andy	mf
Angelia	f
Angie	f
Anissa	f
Ann	f
Annabelle	f
Annice	f
Annie	f
Annis	f
Annmarie	f
Anona	f
Ansel	m
Anson	m
Anthony	m
Antonette	f
Antony	m
April	f
Arabella	f
Arden	mf
Aretha	f
Aria	f
Aric	m
Arleen	f
Arlen	m
Arlene	f
Arlie	mf
Arline	f
Arn	m
Arnie	m
Arron	m
Art	m
Arvel	m
Ash	mf
Ashley	mf
Ashton	mf
Aubrey	mf
Audie	f
Audley	m
Audra	f
Audrey	f
Augustine	m
Aura	f
Austin	m
Autumn	f
Ava	f
Avery	mf
Avis	f
Babs	f
Bailey	mf
Bambi	f
Barb	f
Barbie	f
Barbra	f
Barney	m
Barrett	m
Basil	m
Baxter	m
Bea	f
Beau	m
Becca	f
Becka	f
Beckah	f
Becky	f
Bee	f
Belinda	f
Bella	f
Belle	f
Benedict	m
Benj	m
Benji	m
Benjy	m
Bennett	m
Bennie	m
Benny	m
Benson	m
Bentley	m
Benton	m
Bernadine	f
Bernetta	f
Bernie	mf
Berniece	f
Berry	m
Bertie	mf
Bertina	f
Beryl	f
Bess	f
Bessie	f
Beth	f
Betsy	f
Bette	f
Bettie	f
Betty	f
Bettye	f
Bev	f
Beverley	f
Beverly	mf
Bill	m
Billie	mf
Billy	m
Bindy	f
Bishop	m
Blaine	m
Blake	m
Blanch	f
Blossom	f
Bobbi	f
Bobbie	mf
Bobby	m
Bonita	f
Bonnie	f
Booker	m
Boyce	m
Cade	m
Cal	m
Cale	m
Calla	f
Callahan	m
Callie	f
Calvin	m
Cam	mf
Cammie	f
Candi	f
Candice	f
Candis	f
Candy	f
Candyce	f
Caren	f
Cari	f
Carissa	f
Carlene	f
Carleton	m
Carlie	f
Carlisle	m
Carlton	m
Carly	f
Carlyle	m
Carlyn	f
Carmella	f
Carol	mf
Carolyn	f
Carrie	f
Carry	f
Carter	m
Cary	mf
Caryl	f
Caryn	f
Casey	mf
Cash	m
Casimir	m
Cass	mf
Cassie	f
Catharine	f
Cathryn	f
Cathy	f
Ceadda	m
Cecelia	f
Cecil	m
Cecily	f
Cedric	m
Celestine	mf
Chad	m
Chadwick	m
Chance	m
Chandler	m
Chanel	f
Chantel	f
Chantelle	f
Charissa	f
Charisse	f
Charity	f
Charla	f
Charleen	f
Charlene	f
Charley	mf
Charlie	mf
Charlton	m
Charmaine	f
Chas	m
Chase	m
Chasity	f
Chastity	f
Chauncey	m
Chaz	m
Chelle	f
Chelsea	f
Cher	f
Cheri	f
Cherie	f
Cherilyn	f
Cherise	f
Cherish	f
Cherry	f
Cheryl	f
Chesley	m
Chester	m
Chet	m
Cheyenne	mf
Chip	m
Chris	mf
Chrissie	f
Chrissy	f
Christal	f
Christi	f
Christie	f
Christopher	m
Christy	f
Chrystal	f
Chuck	m
Cicely	f
Cindi	f
Cindy	f
Cissy	f
Clare	f
Clarence	m
Claribel	f
Clarice	f
Clarinda	f
Clark	m
Claud	m
Clay	m
Clayton	m
Clem	m
Clemence	f
Clement	m
Cleo	f
Cletus	m
Cleve	m
Cleveland	m
Cliff	m
Clifford	m
Clifton	m
Clint	m
Clinton	m
Clive	m
Clotilda	f
Clyde	m
Coby	mf
Colbert	m
Colby	m
Cole	m
Coleen	f
Colin	m
Colleen	f
Collin	m
Connie	f
Conway	m
Cooper	m
Cora	f
Coral	f
Corbin	m
Cordelia	f
Cordell	m
Coretta	f
Corey	m
Cori	f
Corie	f
Corine	f
Cornell	m
Corrie	f
Corrina	f
Corrine	f
Cortney	mf
Corwin	m
Cory	m
Cosmo	m
Courtney	mf
Crawford	m
Cristal	f
Crystal	f
Cullen	m
Curt	m
Curtis	m
Cy	m
Cyndi	f
Daisy	f
Dale	mf
Dallas	m
Dalton	m
Damion	m
Dana	mf
Dane	m
Danette	f
Dani	f
Daniella	f
Danita	f
Danni	f
Dannie	m
Danny	m
Darby	mf
Darcy	mf
Darell	m
Daren	m
Darian	mf
Darien	m
Darin	m
Darla	f
Darleen	f
Darlene	f
Darnell	m
Darrel	m
Darrell	m
Darren	m
Darrin	m
Darryl	m
Darwin	m
Daryl	m
Dave	m
Davey	m
Davie	m
Davin	m
Davis	m
Davy	m
Dawn	f
Dawson	m
Dax	m
Dayna	f
Dayton	m
Dean	m
Deana	f
Deanna	f
Deanne	f
Deb	f
Debbi	f
Debbie	f
Debby	f
Debi	f
Debra	f
Dee	mf
Deeann	f
Deena	f
Deforest	m
Deidra	f
Deidre	f
Delbert	m
Dell	mf
Della	f
Delmar	m
Delora	f
Delores	f
Deloris	f
Delphia	f
Delta	f
Den	m
Dena	f
Denice	f
Denny	m
Denton	m
Denver	m
Denzil	m
Deon	m
Derek	m
Derick	m
Derrick	m
Des	m
Desiree	f
Destiny	f
Devon	mf
Dewayne	m
Dexter	m
Di	f
Diann	f
Dianna	f
Dick	m
Dillon	m
Dione	f
Dionne	f
Dixie	f
Dixon	m
Docia	f
Dodie	f
Dollie	f
Dolly	f
Dolph	m
Dom	m
Domenic	m
Dominic	m
Dominick	m
Don	m
Dona	f
Donna	f
Donnie	m
Donny	m
Doreen	f
Doretta	f
Dorinda	f
Dorine	f
Dorothy	f
Dorris	f
Dortha	f
Dorthy	f
Dory	f
Dot	f
Dottie	f
Dotty	f
Doug	m
Drake	m
Dre	m
Drea	f
Drew	m
Dudley	m
Duke	m
Dulcie	f
Durward	m
Dustin	m
Dusty	mf
Dwain	m
Dwayne	m
Dwight	m
Dyan	f
Earl	m
Earle	m
Earlene	f
Earline	f
Earnest	m
Earnestine	f
Eartha	f
Easter	f
Ebba	f
Eben	m
Ebony	f
Ed	m
Eddie	mf
Eddy	m
Edie	f
Edison	m
Edwin	m
Edwina	f
Edythe	f
Effie	f
Egbert	m
Eldon	m
Eldred	m
Elea	f
Eleanor	f
Eleanora	f
Eleanore	f
Elenora	f
Elfreda	f
Elfrieda	f
Elinor	f
Eliot	m
Elissa	f
Eliza	f
Ella	f
Ellen	f
Ellery	m
Ellie	f
Elliot	m
Elliott	m
Ellis	m
Elmer	m
Elmira	f
Elnora	f
Eloise	f
Elouise	f
Elroy	m
Elsie	f
Elton	m
Elvin	m
Elvina	f
Elvis	m
Elwin	m
Elwood	m
Elwyn	m
Ely	m
Elyse	f
Em	f
Emelia	f
Emerson	mf
Emery	mf
Emily	f
Emmaline	f
Emmet	m
Emmett	m
Emmie	f
Emory	m
Enola	f
Eppie	f
Erick	m
Ericka	f
Erle	m
Erma	f
Ern	m
Ernie	m
Errol	m
Essie	f
Esta	f
Estella	f
Ethel	f
Ethelbert	m
Ethelyn	f
Etta	f
Ettie	f
Eugene	m
Eula	f
Eustace	m
Evaline	f
Evalyn	f
Evangeline	f
Everett	m
Everette	m
Evette	f
Evie	f
Evonne	f
Evvie	f
Ewart	m
Fae	f
Faith	f
Fannie	f
Faron	m
Farrell	m
Fawn	f
Fay	f
Faye	f
Felicity	f
Femie	f
Fenton	m
Ferdie	m
Ferdy	m
Fern	f
Ferne	f
Fletcher	m
Flick	f
Flo	f
Florrie	f
Flossie	f
Floyd	m
Ford	m
Forest	m
Forrest	m
Foster	m
Fran	f
Frances	f
Frank	m
Frankie	mf
Franklin	m
Franklyn	m
Frannie	f
Franny	mf
Freda	f
Freddie	mf
Freddy	m
Frederick	m
Fredrick	m
Freeman	m
Frona	f
Fulton	m
Gabby	mf
Gabe	m
Gail	f
Gale	f
Gale	m
Galen	m
Garey	m
Garfield	m
Garland	m
Garnet	f
Garnet	mf
Garnett	mf
Garret	m
Garrett	m
Garrick	m
Garth	m
Gary	m
Gay	f
Gaye	f
Gayla	f
Gayle	mf
Gaylord	m
Gena	f
Gene	m
Geneva	f
Genevieve	f
Genevra	f
Genie	f
Geoff	m
Geoffrey	m
Geordie	m
Georgeanna	f
Georgene	f
Georgiana	f
Georgie	mf
Geraldine	f
German	m
Gerry	mf
Gertie	f
Gib	m
Gil	m
Giles	m
Gill	f
Gillian	f
Ginger	f
Ginnie	f
Ginny	f
Godfrey	m
Goldie	f
Gord	m
Gorden	m
Gordie	m
Gordy	m
Grace	f
Gracie	f
Granville	m
Gray	m
Greg	m
Gregg	m
Gregory	m
Gretta	f
Griffin	m
Grover	m
Gussie	f
Hadley	mf
Hal	m
Hale	m
Hall	m
Hallie	f
Hamilton	m
Hank	m
Harding	m
Hardy	m
Harlan	m
Harland	m
Harley	mf
Harmon	m
Harmony	f
Harold	m
Harper	mf
Harriet	f
Harriett	f
Harriette	f
Harris	m
Harrison	m
Harry	m
Hartley	m
Harve	m
Harvey	m
Harvie	m
Hattie	f
Hatty	f
Haven	mf
Hayden	mf
Haywood	m
Hazel	f
Heath	m
Heather	f
Hellen	f
Henderson	m
Henrietta	f
Henry	m
Herb	m
Herbie	m
Hervey	m
Hettie	f
Hilary	mf
Hildred	mf
Hillary	f
Hollie	f
Hollis	mf
Holly	f
Hope	f
Horatio	m
Howard	m
Howie	m
Hoyt	m
Hudson	m
Huey	m
Hugh	m
Hughie	m
Humphrey	m
Hunter	mf
Ibbie	f
Idella	f
Iggy	m
Ike	m
Ilene	f
Imogene	f
India	f
Indiana	mf
Ingram	m
Irwin	m
Isadora	f
Isadore	m
Isiah	m
Issac	m
Issy	m
Ivy	f
Izzy	mf
Jaci	f
Jack	m
Jacki	f
Jackie	mf
Jacklyn	f
Jackson	m
Jaclyn	f
Jacquelyn	f
Jada	f
Jade	f
Jaime	f
Jaimie	f
Jake	m
Jamey	m
Jami	f
Jamison	m
Jan	f
Jane	f
Janel	f
Janelle	f
Janene	f
Janet	f
Janette	f
Janey	f
Janice	f
Janie	f
Janine	f
Janis	f
Jannette	f
Jarod	m
Jarred	m
Jarrett	m
Jarrod	m
Jarvis	m
Jasmine	f
Jay	m
Jaye	f
Jayme	f
Jayne	f
Jaynie	f
Jayson	m
Jeana	f
Jeane	f
Jeanie	f
Jeanna	f
Jeannie	f
Jeb	m
Jed	m
Jeff	m
Jefferson	m
Jeffery	m
Jeffrey	m
Jeffry	m
Jen	f
Jena	f
Jenelle	f
Jenifer	f
Jenn	f
Jenna	f
Jenni	f
Jennie	f
Jennifer	f
Jenny	f
Jerald	m
Jeri	f
Jermaine	m
Jerold	m
Jerome	m
Jerri	f
Jerrie	f
Jerrod	m
Jerrold	m
Jerry	mf
Jess	mf
Jessa	f
Jessica	f
Jessie	m
Jessye	f
Jewel	mf
Jewell	mf
Jill	f
Jillian	f
Jillie	f
Jilly	f
Jim	m
Jimi	m
Jimmie	mf
Jimmy	m
Jinny	f
Jo	f
Joan	f
Joanie	f
Joann	f
Joanne	f
Jocelyn	mf
Jodi	f
Jodie	f
Jody	mf
Joe	m
Joella	f
Joelle	f
Joetta	f
Joey	m
Johnathan	m
Johnathon	m
Johnie	mf
Johnna	f
Johnnie	mf
Johnny	m
Jojo	mf
Joleen	f
Jolene	f
Jon	m
Jonathon	m
Joni	f
Jonie	f
Jonny	m
Jools	mf
Jordon	m
Jorie	f
Josh	m
Josie	f
Joss	mf
Joy	f
Joyce	mf
Joye	f
Judd	m
Judi	f
Judie	f
Judy	f
Jules	mf
Julianne	f
Juliet	f
June	f
Junior	m
Justice	mf
Justy	mf
Kallie	f
Kandi	f
Kara	f
Karissa	f
Karlene	f
Karolyn	f
Karrie	f
Karyn	f
Kasey	mf
Kat	f
Kate	f
Katey	f
Katharyn	f
Katherine	f
Katheryn	f
Kathi	f
Kathie	f
Kathlyn	f
Kathryn	f
Kathy	f
Katie	f
Katy	f
Kay	f
Kaye	f
Kayla	f
Keely	f
Kelley	mf
Kelli	f
Kellie	f
Kelsey	mf
Kelvin	m
Ken	m
Kendra	f
Kendrick	m
Kennard	m
Kennith	m
Kent	m
Kenton	m
Kenyon	m
Kenzie	mf
Keri	f
Kermit	m
Kerri	f
Kerrie	f
Kerry	mf
Kev	m
Kiki	f
Kiley	f
Kim	mf
Kimball	m
Kimberlee	f
Kimberley	f
Kimberly	f
Kimmie	f
Kimmy	f
King	m
Kip	m
Kira	f
Kirby	m
Kirk	m
Kit	mf
Kitty	f
Kizzie	f
Kizzy	f
Knox	m
Korey	m
Kori	f
Kory	m
Kristal	f
Kristen	f
Kristi	f
Kristie	f
Kristopher	m
Kristy	f
Krystal	f
Kurtis	m
Kyla	f
Kyle	m
Kylee	f
Kylie	f
Kyra	f
Lacey	mf
Lacy	mf
Lamar	m
Lamont	m
Lance	m
Landon	m
Lane	m
Laney	f
Lanny	m
Laraine	f
Larissa	f
Larkin	m
Larrie	m
Larry	m
Laureen	f
Laurel	f
Lauren	mf
Laurence	m
Laurene	f
Laurie	mf
Laurine	f
Lavern	mf
Laverne	mf
Lavina	f
Lavonne	f
Lawrence	m
Lawrie	m
Lawson	m
Layne	m
Layton	m
Laz	m
Leann	f
Leanna	f
Leanne	f
Leatrice	f
Lee	mf
Leeann	f
Leesa	f
Leigh	mf
Leighton	m
Lela	f
Leland	m
Len	m
Lenard	m
Lenora	f
Lenore	f
Leola	f
Leone	f
Leroy	m
Les	m
Lesia	f
Lesley	mf
Leslie	mf
Lessie	f
Lester	m
Leta	f
Letha	f
Letitia	f
Lettie	f
Letty	f
Lewis	m
Lex	m
Lexa	f
Lexi	f
Lexia	f
Lexie	f
Lexine	f
Lexus	f
Lexy	f
Libby	f
Liberty	f
Liddy	f
Lilibeth	f
Lillia	f
Lillian	f
Lillie	f
Lilly	f
Lily	f
Lincoln	m
Linden	m
Lindy	mf
Linette	f
Linnie	f
Linton	m
Linwood	m
Lisha	f
Lissa	f
Lita	f
Livia	f
Livvy	f
Liz	f
Lizbeth	f
Lizette	f
Lizzie	f
Lizzy	f
Lloyd	m
Lockie	m
Lon	m
Lonnie	m
Lonny	m
Loraine	f
Lorayne	f
Loreen	f
Loren	mf
Lorena	f
Lorene	f
Lori	f
Lorie	f
Lorin	m
Lorinda	f
Lorne	m
Lorraine	f
Lorri	f
Lorrie	f
Lottie	f
Louella	f
Louie	m
Louisa	f
Love	f
Lovell	m
Lowell	m
Loyd	m
Luann	f
Luanne	f
Lucetta	f
Lucky	m
Lucy	f
Luella	f
Lula	f
Luther	m
Luvenia	f
Luvinia	f
Lyle	m
Lyn	f
Lynda	f
Lyndon	m
Lynette	f
Lynn	mf
Lynne	f
Lynnette	f
Lynwood	m
Lyssa	f
Mabel	f
Mabelle	f
Mable	f
Macie	f
Mack	m
Mackenzie	mf
Macy	f
Madalyn	f
Maddie	f
Madelyn	f
Madge	f
Madison	mf
Madlyn	f
Madonna	f
Mae	f
Magdalen	f
Maggie	f
Magnolia	f
Mahala	f
Mahalia	f
Major	m
Malcom	m
Malinda	f
Mamie	f
Mandi	f
Mandy	f
Manley	m
Manny	m
Maralyn	f
Marci	f
Marcie	f
Marcy	f
Margaret	f
Margaretta	f
Marge	f
Margery	f
Margie	f
Margo	f
Mariah	f
Marian	f
Mariel	f
Marilyn	f
Marilynn	f
Marinda	f
Marion	m
Marissa	f
Marje	f
Marjorie	f
Marjory	f
Marla	f
Marlin	m
Marlon	m
Marlyn	mf
Marnie	f
Marsha	f
Marshal	m
Marshall	m
Martie	m
Marty	m
Marva	f
Maryann	f
Maryanne	f
Marybeth	f
Marylou	f
Marylyn	f
Mason	m
Mat	m
Mathew	m
Matt	m
Mattie	mf
Matty	m
Maude	f
Maudie	f
Maverick	m
Mavis	f
Maximillian	m
Maxine	f
Maxwell	m
May	f
Maya	f
Maybelle	f
Mayme	f
Maynard	m
Meagan	f
Meaghan	f
Meg	f
Meghan	f
Mel	mf
Melba	f
Melina	f
Melinda	f
Melody	f
Melva	f
Melville	m
Melvin	m
Melvyn	m
Mercy	f
Merilyn	f
Merle	mf
Merlyn	mf
Merrill	m
Merritt	m
Merry	f
Merton	m
Merv	m
Meryl	f
Micheal	m
Mick	m
Mickey	mf
Micky	m
Mike	m
Mikki	f
Milburn	m
Mildred	f
Miles	m
Milford	m
Millard	m
Millicent	f
Millie	f
Milo	m
Milton	m
Mindy	f
Minnie	f
Miranda	f
Missie	f
Missy	f
Misti	f
Misty	f
Mitch	m
Mitchell	m
Mo	mf
Moe	m
Mollie	f
Molly	f
Monna	f
Monte	m
Montgomery	m
Monty	m
Morris	m
Mort	m
Mortimer	m
Morton	m
Morty	m
Myles	m
Myra	f
Myrtie	f
Myrtle	f
Nan	f
Nancy	f
Nanette	f
Nannie	f
Nanny	f
Nat	m
Nate	m
Neal	m
Ned	m
Neely	m
Nelda	f
Nell	f
Nella	f
Nelle	f
Nellie	f
Nelly	f
Nelson	m
Nena	f
Nessa	f
Netta	f
Nettie	f
Neva	f
Nevada	f
Newt	m
Newton	m
Nic	m
Nichole	f
Nickolas	m
Nicky	mf
Nigel	m
Nikki	f
Nikole	f
Niles	m
Nita	f
Noble	m
Noel	m
Noelle	f
Nona	f
Nonie	f
Norm	m
Norman	m
Normand	m
Norris	m
Norton	m
Norwood	m
Nova	f
Odelia	f
Odell	mf
Ogden	m
Oli	m
Olive	f
Ollie	mf
Oneida	f
Opal	f
Ophelia	f
Ora	mf
Orson	m
Orval	m
Orville	m
Osborn	m
Osborne	m
Otis	m
Oz	m
Ozzie	m
Ozzy	m
Page	m
Paige	f
Palmer	m
Pam	f
Pamela	f
Pamelia	f
Pamella	f
Pansy	f
Parker	mf
Pat	mf
Patience	f
Patti	f
Pattie	f
Patty	f
Pauletta	f
Paulie	m
Pearl	mf
Pearle	f
Pearlie	f
Peg	f
Peggie	f
Peggy	f
Pen	f
Penny	f
Perce	m
Percy	m
Perry	m
Pete	m
Peyton	mf
Phemie	f
Pheobe	f
Phil	m
Phillip	m
Phillis	f
Phyliss	f
Pierce	m
Pip	m
Pippa	f
Pollie	f
Polly	f
Porter	m
Portia	f
Posie	f
Posy	f
Presley	mf
Preston	m
Prince	m
Pris	f
Prissy	f
Pru	f
Prudence	f
Prue	f
Queen	f
Queenie	f
Quincy	m
Quinten	m
Quintin	m
Quinton	m
Rachael	f
Racheal	f
Rachelle	f
Racquel	f
Rae	f
Rafe	m
Raleigh	m
Ralphie	m
Ramsey	m
Randal	m
Randall	m
Randell	m
Randi	f
Randolf	m
Randolph	m
Randy	m
Raven	mf
Ray	m
Raynard	m
Reba	f
Red	m
Reed	m
Reg	m
Regan	f
Regena	f
Reggie	m
Reginald	m
Reid	m
Rena	f
Renae	f
Renee	f
Renita	f
Retha	f
Rex	m
Reynold	m
Rhett	m
Rhonda	f
Rian	m
Rich	m
Richelle	f
Richie	m
Rick	m
Rickey	m
Ricki	mf
Rickie	m
Ricky	m
Riley	mf
Rilla	f
Ritchie	m
Robbie	mf
Robby	m
Robin	mf
Robyn	f
Rochelle	f
Rocky	m
Rod	m
Rodge	m
Rodger	m
Rodney	m
Rolland	m
Rollo	m
Roly	m
Ron	m
Rona	f
Ronda	f
Roni	f
Ronnie	mf
Ronny	m
Roosevelt	m
Ros	f
Rosalind	f
Rosaline	f
Rosalyn	f
Rosamond	f
Rosanne	f
Roscoe	m
Roseann	f
Roseanne	f
Roselyn	f
Rosemary	f
Rosie	f
Roslyn	f
Roswell	m
Rosy	f
Rowena	f
Rowland	m
Rowley	m
Roxanna	f
Roxie	f
Roxy	f
Royal	m
Royce	m
Roz	f
Rozanne	f
Rube	m
Ruby	f
Rubye	f
Rudolph	m
Rudy	m
Rue	f
Russ	m
Russel	m
Russell	m
Rusty	m
Ruthie	f
Sadie	f
Sal	mf
Salina	f
Sallie	f
Sally	f
Sam	mf
Samantha	f
Sammie	mf
Sammy	m
Sampson	m
Sandy	mf
Sanford	m
Savannah	f
Scarlett	f
Schuyler	m
Selina	f
Serina	f
Seward	m
Seymour	m
Shad	m
Shan	f
Shana	f
Shanna	f
Shannon	mf
Shanon	mf
Shantel	f
Shari	f
Sharla	f
Sharleen	f
Sharlene	f
Sharron	f
Sharyl	f
Sharyn	f
Shaun	m
Shauna	f
Shawn	m
Shawna	f
Shawnda	f
Shayla	f
Shayne	m
Shel	m
Shelby	mf
Sheldon	m
Shelia	f
Shell	f
Shelley	mf
Shelly	mf
Shelton	m
Sheree	f
Sheri	f
Sheridan	mf
Sherie	f
Sherilyn	f
Sherman	m
Sherri	f
Sherrie	f
Sherry	f
Sherwood	m
Sheryl	f
Sheryll	f
Shirlee	f
Shirley	mf
Shonda	f
Sibyl	f
Sid	m
Sidney	mf
Silver	m
Sissie	f
Sissy	f
Sly	m
Smith	m
Sondra	f
Sonny	m
Spencer	m
Spring	f
Stacey	mf
Staci	f
Stacia	f
Stacie	f
Stacy	mf
Stafford	m
Stan	m
Stanford	m
Stanley	m
Star	f
Starla	f
Starr	f
Ste	m
Stella	f
Steph	mf
Stephania	f
Stephany	f
Sterling	m
Steve	m
Steven	m
Stevie	mf
Stew	m
Stewart	m
Stu	m
Sue	f
Suellen	f
Sukie	f
Sullivan	m
Summer	f
Sunday	f
Sunny	f
Sunshine	f
Susan	f
Susie	f
Suzan	f
Suzanna	f
Suzie	f
Suzy	f
Sybil	f
Syd	m
Sydney	mf
Sylvester	m
Tabatha	f
Tabby	f
Tad	m
Tameka	f
Tamela	f
Tamera	f
Tami	f
Tamika	f
Tammi	f
Tammie	f
Tammy	f
Tamra	f
Tania	f
Tanner	m
Tara	f
Taryn	f
Tate	m
Taylor	mf
Ted	m
Teddy	m
Tera	f
Terance	m
Terence	m
Teri	f
Terra	f
Terrance	m
Terrell	m
Terrence	m
Terri	f
Terrie	f
Terry	mf
Terry	mf
Tess	f
Tessa	f
Tessie	f
Tex	m
Thad	m
Thelma	f
Theodore	m
Thom	m
Thomasina	f
Thornton	m
Tia	f
Tiana	f
Tibby	mf
Tiffani	f
Tiffany	f
Tillie	f
Tilly	f
Timmy	m
Titty	f
Tobin	m
Toby	mf
Tod	m
Todd	m
Tommie	mf
Tommy	m
Toni	f
Tonia	f
Tony	m
Tonya	f
Topher	m
Tori	f
Toria	f
Tottie	f
Totty	f
Trace	m
Tracee	f
Tracey	mf
Traci	f
Tracie	f
Tracy	mf
Travis	m
Trent	m
Trenton	m
Trey	m
Tricia	f
Trina	f
Trinity	f
Trish	f
Trisha	f
Trista	f
Trix	f
Trixie	f
Troy	m
Truman	m
Twila	f
Twyla	f
Ty	m
Tye	m
Tyler	mf
Tyron	m
Tyrone	m
Tyson	m
Val	mf
Valarie	f
Valentine	m
Valerie	f
Valorie	f
Van	m
Vance	m
Vanessa	f
Velda	f
Velma	f
Velvet	f
Vere	m
Vergil	m
Vern	m
Verna	f
Vernon	m
Veva	f
Vi	f
Vic	mf
Vicki	f
Vickie	f
Vicky	f
Vikki	f
Vin	m
Vinnie	m
Vinny	m
Violet	f
Virgee	f
Virgie	f
Vivian	mf
Vonda	f
Wade	m
Walker	m
Wally	m
Walt	m
Walton	m
Ward	m
Wardell	m
Warner	m
Warren	m
Washington	m
Wat	m
Wayland	m
Waylon	m
Wayne	m
Webster	m
Weldon	m
Wendell	m
Wendi	f
Wendy	f
Wesley	m
Westley	m
Weston	m
Whitney	mf
Wil	m
Wilbur	m
Wilburn	m
Wilda	f
Wiley	m
Wilf	m
Wilford	m
Wilfred	m
Wilfrid	m
Wilkie	m
Will	m
Willa	f
Willard	m
William	m
Willie	mf
Willis	m
Wilmer	m
Wilson	m
Wilton	m
Winfred	m
Winnie	f
Winston	m
Winthrop	m
Winton	m
Woodrow	m
Woody	m
Wright	m
Wyatt	m
Wynona	f
Yancy	m
Yolonda	f
York	m
Zac	m
Zach	m
Zachary	m
Zachery	m
Zack	m
Zackary	m
Zackery	m
Zak	m
Zandra	f
Zane	m
Zanna	f
Zed	m
Zeke	m
Zelda	f
Zelma	f
Zena	f
Zeph	m
Zola	f
Zula	f
Baldwin	m
Myron	m
Homer	m
Agatha	f
Melissa	f
Octavia	f
Priscilla	f
Andrew	m
Bartholomew	m
Bethany	f
Caleb	m
Elizabeth	f
James	m
Jared	m
Jeremiah	m
Joel	m
John	m
Jonah	m
Jordan	mf
Joshua	m
Jude	m
Lois	f
Luke	m
Mary	f
Matthew	m
Noah	m
Sharon	f
Stephen	m
Timothy	m
Jeremy	m
Nathaniel	m
Phebe	f
Zachariah	m
Candace	f
Thaddeus	m
Hester	f
Dina	f
Tabitha	f
Abner	m
Bernice	f
Carmel	f
Moses	m
Cyrus	m
Aaron	m
Chloe	f
Angel	mf
Cyril	m
Kris	mf
Alex	mf
Amber	f
Annabel	f
Bart	m
Ben	m
Bert	m
Bob	m
Elly	f
Emmy	f
Fred	m
Gerard	m
Maud	f
Nick	m
Rob	m
Theo	m
Tom	m
Trudie	f
Trudy	f
Jesse	m
Lucas	m
Linda	f
Georgina	f
Jacob	m
Herman	m
Fanny	f
Alison	f
Charles	m
Constance	f
Dorian	m
Edgar	m
Estelle	f
Eveline	f
Florence	mf
Francis	mf
Guy	m
Horace	m
Lilian	f
Lou	mf
Madeline	f
Maurice	m
Nicholas	m
Raymond	m
Rose	f
Roxanne	f
Eve	f
Nathan	m
Vincent	m
Gilbert	m
Joseph	m
Richard	m
Benjamin	m
Adam	m
Thomas	m
Paul	m
Sarah	f
Roland	m
Christian	m
Martin	m
Albert	m
Roger	m
Arthur	m
Hector	m
Jason	m
Isidore	m
Muriel	f
Emma	f
Bernard	m
Xavier	m
Alice	f
Victor	m
Robert	m
Simon	m
Alfred	m
Ernest	m
Justin	m
Esther	f
Abel	m
Samuel	m
Eric	m
Cara	f
Carina	f
Evelyn	mf
Gerald	m
Josephine	f
Katharine	f
Lara	f
Leona	f
Marvin	m
Stephanie	f
Floretta	f
Arnold	m
Bertram	m
Conrad	m
Waldo	m
Corinna	f
Doris	f
Oswald	m
Salome	f
Abigail	f
Lydia	f
Michael	m
Andrea	f
Dennis	m
Gertrude	f
Melanie	f
Willy	mf
Frank	m
Hubert	m
Claudia	f
Beatrix	f
Aloysius	m
Agnes	f
Hilda	f
Alexander	m
Lisa	f
Peter	m
Tim	m
Herbert	m
Elmo	m
Flora	f
Philomena	f
Edmund	m
Ada	f
Leon	m
Corina	f
Selma	f
Theresa	f
Ruth	f
Christina	f
Edith	f
Ina	f
Jonathan	m
Ida	f
Julia	f
Walter	m
Oliver	m
Katrina	f
Elsa	f
Georgia	f
Nikolas	m
Helen	f
Cassandra	f
Cynthia	f
Phoebe	f
Theodora	f
Zoe	f
Silas	m
Sophia	f
Abe	m
Isaiah	m
Isaac	m
Ethan	m
Judith	f
Deborah	f
Elijah	m
Naomi	f
Eli	m
Leah	f
Abraham	m
Hannah	f
Rachel	f
Daniel	m
David	m
Vince	m
Cody	m
Coleman	m
Desmond	m
Devin	mf
Duane	m
Erin	f
Maurine	f
Nola	f
Reagan	mf
Kevin	m
Deirdre	f
Oscar	m
Kennedy	mf
Lora	f
Loretta	f
Luana	f
Mina	f
Norma	f
Rina	f
Serena	f
Berenice	f
Barbara	f
Sabrina	f
Cornelia	f
Angela	f
Anna	f
Alberta	f
Regina	f
Clarissa	f
Monica	f
Veronica	f
Angelica	f
Lina	f
Viola	f
Camilla	f
Tina	f
Roberta	f
Olivia	f
Delia	f
Gloria	f
Virginia	f
Sonia	f
Irene	f
Cecilia	f
Evelina	f
Rebecca	f
Jasper	m
Christiana	f
Darius	m
Winona	f
Adrianna	f
Damian	m
Edward	m
Marlena	f
Wanda	f
Leonard	m
Joanna	f
Julian	m
Lucinda	f
Calista	f
George	m
Virgil	m
Dan	m
Adrian	m
Lana	f
Mark	m
Liza	f
Ella	f
Philip	m
Ralph	m
Sylvia	f
Ursula	f
Rita	f
Martha	f
Allan	m
Allen	m
Garry	m
Gavin	m
Grant	m
Gus	m
Iona	f
Irvin	m
Irvine	m
Irving	m
Jean	f
Keith	m
Lindsay	mf
Lindsey	mf
Lorna	f
Roddy	m
Scot	m
Scott	m
Scottie	m
Scotty	m
Stuart	m
Wallace	m
Alan	m
Roderick	m
Justina	f
Adelia	f
Alma	f
Dora	f
Esmeralda	f
Griselda	f
Marcia	f
Felicia	f
Celia	f
Amelia	f
Diana	f
Laura	f
Adela	f
Patricia	f
Amanda	f
Roxana	f
Victoria	f
Erica	f
Lennie	mf
Lenny	m
Mathilda	f
Tilda	f
Matilda	f
Jolie	f
Kendall	mf
Elaine	f
Jere	m
Marie	f
Adeline	f
Aline	f
Annette	f
Bernadette	f
Blanche	f
Caroline	f
Catherine	f
Clair	m
Claire	f
Claude	mf
Corinne	f
Danielle	f
Denise	f
Diane	f
Dianne	f
Francine	f
Gabrielle	f
Hortense	f
Jacqueline	f
Jeanette	f
Jeanine	f
Jeanne	f
Jeannette	f
Jeannine	f
Julie	f
Justine	f
Lisette	f
Lucile	f
Lucille	f
Madeleine	f
Marion	f
Michelle	f
Prosper	m
Quentin	m
Romaine	f
Roxane	f
Simone	f
Suzanne	f
Yvette	f
Yvonne	f
Bertrand	m
Chantal	f
Louis	m
Louise	f
Marilou	f
Nicole	f
Isabelle	f
Natalie	f
Sophie	f
Marianne	f
Pauline	f
Charlotte	f
Christine	f
Nadia	f
Anne	f
Ernestine	f
Gabriel	m
Denis	m
Lise	f
Christa	f
Magdalene	f
Dorothea	f
Wilma	f
Leo	m
Rupert	m
Leopold	m
Lambert	m
Elisabeth	f
Felix	m
Heidi	f
Helena	f
Magdalena	f
Frieda	f
Gretchen	f
Jasmin	f
Krista	f
Marlene	f
Romy	f
Trudi	f
Bertha	f
Norbert	m
Paula	f
Adele	f
Maximilian	m
Max	m
Sebastian	m
Silvester	m
Ferdinand	m
Raphael	m
Alexis	mf
Irma	f
Augusta	f
Elisa	f
Daniela	f
August	m
Emil	m
Elise	f
Otto	m
Alexandra	f
Martina	f
Carl	m
Rolf	m
Sigmund	m
Thea	f
Karl	m
Michaela	f
Damon	m
Ione	f
Penelope	f
Daphne	f
Phyllis	f
Iris	f
Anastasia	f
Petra	f
Elias	m
Sara	f
Israel	m
Miriam	f
Julianna	f
Barrie	m
Barry	m
Biddy	f
Caitlin	f
Carey	mf
Cathleen	f
Conor	m
Delma	f
Eileen	f
Grady	m
Honora	f
Kathleen	f
Keegan	m
Kelly	mf
Maureen	f
Mona	f
Moreen	f
Murphy	mf
Nolan	m
Norah	f
Noreen	f
Norene	f
Patsy	mf
Quinn	mf
Ryan	m
Sean	m
Shane	m
Shavonne	f
Sheila	f
Patrick	m
Nora	f
Edna	f
Maura	f
Neil	m
Beatrice	f
Celeste	mf
Rosanna	f
Marianna	f
Sandra	f
Angelina	f
Gina	f
Lucia	f
Clara	f
Gabriella	f
Daria	f
Maria	mf
Liana	f
Carla	f
Antonia	f
Isabella	f
Carolina	f
Marisa	f
Eva	f
Aurora	f
Adriana	f
Liliana	f
Silvia	f
Eugenia	f
Susanna	f
Candida	f
Alfreda	f
Frederica	f
Minerva	f
Ulysses	m
Lucian	m
Ivan	m
Natasha	f
Sonya	f
Tamara	f
Tanya	f
Tasha	f
Vera	f
Lara	f
Nina	f
Tatiana	f
Mia	f
Erik	m
Erika	f
Karin	f
Kristin	f
Lena	f
Karina	f
Kristina	f
Archibald	m
Archie	m
Blair	mf
Cameron	mf
Colin	m
Craig	m
Donald	m
Douglas	m
Duncan	m
Evander	m
Frazier	m
Glen	m
Glenn	m
Glenna	f
Gordon	m
Graham	m
Ian	m
Jamie	mf
Jessie	f
Kenneth	m
Kenny	m
Logan	mf
Malcolm	m
Malvina	f
Monroe	m
Murray	m
Ronald	m
Ross	m
Roy	m
Sheena	f
Aileen	f
Angus	m
Carson	mf
Danica	f
Alicia	f
Dolores	f
Evangelina	f
Lola	f
Yolanda	f
Carmen	f
Anita	f
Eulalia	f
Rosa	f
Paulina	f
Raquel	f
Hugo	m
Isabel	f
Manuel	m
Teresa	f
Ramona	f
Greta	f
Merlin	m
Percival	m
Evan	m
Gladys	f
Glenda	f
Gwen	f
Gwenda	f
Gwendolyn	f
Megan	f
Meredith	mf
Mervin	m
Mervyn	m
Owen	m
Trev	m
Trevor	m
Vaughn	m
Winifred	f
Winnifred	f
Morgan	mf
Tristan	m
Dylan	m
Rhiannon	f
