Davina	f
Demelza	f
Gaynor	f
Haydn	m
Imogen	f
Jacquetta	f
Jacqui	f
Jemma	f
Jonty	m
Nichola	f
Nicola	f
Poppy	f
Tamsin	f
Tamsyn	f
Tel	m
Tristram	m
Philippa	f
Piers	m
Ivor	m
Gemma	f
Gwendoline	f
Gareth	m
