Adorinda	f
Alechjo	m
Aleksandro	m
Amika	f
Aminda	f
Anchjo	m
Antono	m
Chiela	f
Dezirinda	f
Esperanta	f
Fajra	f
Fiera	f
Gaja	f
Georgo	m
Glorinda	f
Jochjo	m
Johano	m
Jozefo	m
Juvela	f
Kandajha	f
Karesinda	f
Katida	f
Koralo	m
Luchjo	m
Ludoviko	m
Luksa	f
Marajha	f
Merita	f
Michjo	m
Miela	f
Mihhaelo	m
Mikelo	m
Mirinda	f
Nichjo	m
Nikolao	m
Orabela	f
Pachjo	m
Pipra	f
Rava	f
Rozabela	f
Rubena	f
Safira	f
Sprita	f
Stelara	f
Tondra	f
Valora	f
Venka	f
Vespera	f
Vilchjo	m
Vilhelmo	m
Paulo	m
Petro	m
