Marika	f
Jonna	f
Marja	f
Hannes	m
Mirjam	f
Amalia	f
Frans	m
Fanny	f
Emma	f
Julia	f
Elsa	f
Anna	f
Camilla	f
Olivia	f
Irene	f
Cecilia	f
Ursula	f
Laura	f
Amanda	f
Tilda	f
Matilda	f
Aabraham	m
Aadolf	m
Aamu	f
Aapeli	m
Aapo	m
Aarne	m
Aatami	m
Aatos	m
Aatto	m
Aatu	m
Aimo	m
Aki	m
Akseli	m
Aku	m
Ale	m
Aleksanteri	m
Aliisa	f
Alli	f
Alpertti	m
Altti	m
Anna Liisa	f
Anneli	f
Anni	f
Anniina	f
Annikki	f
Annukka	f
Ansa	f
Anselmi	m
Anssi	m
Antero	m
Antti	m
Anttoni	m
Armas	m
Armo	m
Arto	m
Arttu	m
Artturi	m
Arvo	m
Aukusti	m
Aulis	m
Aune	f
Eelis	m
Eemeli	m
Eemil	m
Eerik	m
Eerika	f
Eerikki	m
Eero	m
Eetu	m
Eeva	f
Eevi	f
Eija	f
Eino	m
Eleonoora	f
Eliina	f
Eliisa	f
Eljas	m
Elli	f
Enni	f
Ensio	m
Erkki	m
Erno	m
Esa	m
Esteri	f
Eveliina	f
Hannele	f
Hannu	m
Heikki	m
Heleena	f
Heli	f
Helka	f
Hellä	f
Henna	f
Henriikka	f
Henrikki	m
Hermanni	m
Hesekiel	m
Hilja	f
Iida	f
Iikka	m
Iines	f
Iiro	m
Iisakki	m
Ilma	f
Ilmari	m
Ilta	f
Impi	f
Inkeri	f
Into	m
Irja	f
Ismo	m
Jaakkima	m
Jaakko	m
Jaakoppi	m
Jaana	f
Jalmari	m
Jalo	m
Jari	m
Jaska	m
Jenni	f
Joni	m
Joona	m
Joonas	m
Jooseppi	m
Jorma	m
Josefiina	f
Jouko	m
Jouni	m
Juha	m
Juhana	m
Juhani	m
Juho	m
Jukka	m
Jussi	m
Juuso	m
Jyri	m
Jyrki	m
Kaapo	m
Kaapro	m
Kaarina	f
Kaarle	m
Kaarlo	m
Kaija	f
Kalevi	m
Kari	m
Karoliina	f
Katri	f
Katriina	f
Kauko	m
Kerttu	f
Kielo	f
Kiira	f
Kirsi	f
Kirsikka	f
Kirsti	f
Kukka	f
Kustaa	m
Kusti	m
Kylli	f
Kyösti	m
Lahja	f
Lari	m
Lassi	m
Launo	m
Lauri	m
Leevi	m
Lempi	f
Liina	f
Liisi	f
Loviisa	f
Lumi	f
Luukas	m
Lyydia	f
Lyyti	f
Maaria	f
Maarit	f
Maija	f
Mainio	m
Margareeta	f
Maritta	f
Marjaana	f
Marjatta	f
Marjo	f
Marjukka	f
Marjut	f
Marketta	f
Markku	m
Martta	f
Martti	m
Matleena	f
Matti	m
Mauno	m
Maunu	m
Mauri	m
Meri	f
Merja	f
Miia	f
Miina	f
Mika	m
Mikko	m
Mimmi	f
Minttu	f
Mirja	f
Mirjami	f
Niilo	m
Niina	f
Nooa	m
Noora	f
Oili	f
Oiva	m
Olavi	m
Olli	m
Onni	m
Orvokki	f
Oskari	m
Osku	m
Otso	m
Paavali	m
Päivä	f
Päivi	f
Pasi	m
Pauli	m
Pauliina	f
Pekka	m
Pentti	m
Pertti	m
Perttu	m
Petri	m
Petteri	m
Pietari	m
Piia	f
Pilvi	f
Pinja	f
Piritta	f
Pirjo	f
Pirkko	f
Priita	f
Pyry	m
Raakel	f
Raimo	m
Ransu	m
Rauha	f
Reeta	f
Reetta	f
Reijo	m
Reima	m
Reino	m
Reko	m
Riika	f
Riikka	f
Riitta	f
Rikhard	m
Riku	m
Ritva	f
Roope	m
Roopertti	m
Ruuben	m
Saara	f
Säde	f
Saija	f
Sakari	m
Sakke	m
Saku	m
Salli	f
Samppa	m
Samuli	m
Santeri	m
Santtu	m
Sari	f
Satu	f
Sauli	m
Seija	f
Senja	f
Sepi	m
Seppo	m
Severi	m
Siiri	f
Silja	f
Sini	f
Sinikka	f
Sirpa	f
Sisko	f
Sisu	m
Sohvi	f
Soini	m
Stiina	f
Sulo	m
Suoma	f
Suvi	f
Sylvi	f
Taavetti	m
Taavi	m
Tahvo	m
Taimi	f
Taina	f
Taisto	m
Taneli	m
Tapani	m
Tarja	f
Tarmo	m
Taru	f
Tatu	m
Tauno	m
Teemu	m
Teija	f
Teppo	m
Terhi	f
Terho	m
Tero	m
Terttu	f
Teuvo	m
Tiia	f
Tiina	f
Timo	m
Toini	f
Toivo	m
Tommi	m
Toni	m
Topi	m
Topias	m
Torsti	m
Tuija	f
Tuomas	m
Tuomo	m
Tuula	f
Tuuli	f
Tyyne	f
Ulriikka	f
Uolevi	m
Urho	m
Usko	m
Väinö	m
Valto	m
Valtteri	m
Vanamo	f
Vappu	f
Varpu	f
Veera	f
Veikko	m
Veli	m
Venla	f
Vesa	m
Vieno	mf
Viivi	f
Vilhelmi	m
Vilhelmiina	f
Vilho	m
Viljami	m
Viljo	m
Ville	m
Vilppu	m
Virva	f
Voitto	m
Vuokko	f
Yrjänä	m
Yrjö	m
Niko	m
Jere	m
Anu	f
Kaisa	f
Katariina	f
Kristiina	f
Leena	f
Liisa	f
Maarika	f
Paavo	m
Riina	f
Ahti	m
Aino	f
Kyllikki	f
Sampo	m
Seppo	m
Tapio	m
Tuulikki	f
Ukko	m
Fanni	f
Jani	m
Kati	f
Tomi	m
Risto	m
Aleksi	m
Matias	m
Aina	f
Simo	m
Elina	f
Helmi	f
Janne	m
Harri	m
Marianne	f
Anne	f
Henri	m
Salomon	m
Inka	f
Kai	m
Heidi	f
Johannes	m
Helena	f
Paula	f
Adele	f
Sebastian	m
Markus	m
Minna	f
Heino	m
Tanja	f
Irma	f
Alina	f
Elisa	f
Otto	m
Johanna	f
Ulrika	f
Hanna	f
Sonja	f
Margareta	f
Marita	f
Petra	f
Elias	m
Kata	f
Sami	m
Samu	m
Ilona	f
Sandra	f
Eleonora	f
Maria	mf
Adelina	f
Aurora	f
Emilia	f
Dorotea	f
Susanna	f
Sofia	f
Janina	f
Irina	f
Ilari	m
Birgitta	f
Joakim	m
Kristian	m
Lasse	m
Mikael	m
Milla	f
Rikard	m
Ulla	f
Elisabet	f
Erik	m
Erika	f
Edvin	m
Hanna	f
Anja	f
Tea	f
Edvard	m
Karin	f
Ester	f
Anita	f
Teresa	f
Annika	f
Fredrik	m
Hillevi	f
Kalle	m
Lotta	f
Niklas	m
Vilhelmina	f
Marko	m
Mari	f
