Marius	m
Emmanuel	m
Ariel	mf
Corentin	m
Pierrick	m
Winoc	m
Yanick	mf
Yann	m
Yannic	mf
Yannick	mf
Anouk	f
Lucas	m
Alison	f
Charles	m
Constance	f
Dorian	m
Edgar	m
Estelle	f
Eveline	f
Florence	mf
Francis	mf
Guy	m
Horace	m
Lilian	f
Lou	mf
Madeline	f
Maurice	m
Nicholas	m
Raymond	m
Rose	f
Roxanne	f
Eve	f
Nathan	m
Vincent	m
Gilbert	m
Joseph	m
Richard	m
Benjamin	m
Adam	m
Thomas	m
Paul	m
Sarah	f
Roland	m
Christian	m
Martin	m
Albert	m
Roger	m
Arthur	m
Hector	m
Jason	m
Isidore	m
Muriel	f
Emma	f
Bernard	m
Xavier	m
Alice	f
Victor	m
Robert	m
Simon	m
Alfred	m
Ernest	m
Justin	m
Esther	f
Abel	m
Samuel	m
Eric	m
Frank	m
Hubert	m
Herbert	m
Ethan	m
Judith	f
Hannah	f
Rachel	f
Daniel	m
David	m
Kevin	m
Barbara	f
Absolon	m
Adélaïde	f
Adèle	f
Adolphe	m
Adrien	m
Adrienne	f
Aglaé	f
Aimé	m
Aimée	f
Alain	m
Albertine	f
Aldéric	m
Alix	f
Alphonse	m
Alphonsine	f
Amable	m
Amandine	f
Amaury	m
Ambre	f
Ambroise	m
Amédée	m
Amélie	f
Anastasie	f
Anatole	m
Andrée	f
Angèle	f
Angeline	f
Angelique	f
Anselme	m
Antoine	m
Antoinette	f
Antonin	m
Apollinaire	m
Apolline	f
Arianne	f
Arielle	f
Aristide	m
Arlette	f
Armand	m
Armel	m
Armelle	f
Arnaud	m
Arnaude	f
Aubert	m
Aubin	m
Aude	f
Auguste	m
Aurèle	m
Aurélie	f
Aurélien	m
Aurore	f
Axelle	f
Babette	f
Baptiste	m
Barnabé	m
Barthélémy	m
Basile	m
Bastien	m
Baudouin	m
Béatrice	f
Bénédicte	f
Benjamine	f
Benoit	m
Benoite	f
Bernardine	f
Berthe	f
Blaise	m
Blandine	f
Camille	mf
Carine	f
Carole	f
Céleste	mf
Célestin	m
Célestine	f
Céline	f
Cerise	f
Césaire	m
Charline	f
Charlot	m
Chloé	f
Christelle	f
Christophe	m
Clarisse	f
Claudette	f
Claudie	f
Claudine	f
Clémence	f
Clément	m
Clementine	f
Clothilde	f
Clotilde	f
Colette	f
Coline	f
Colombe	f
Côme	m
Coralie	f
Corin	m
Cornélie	f
Cosette	f
Cunégonde	f
Cyrielle	f
Cyrille	mf
Damien	m
Danièle	f
Daphné	f
Delphine	f
Déodat	m
Désiré	m
Désirée	f
Didier	m
Dieudonné	m
Dieudonnée	f
Diodore	m
Dominique	mf
Donatien	m
Donatienne	f
Doriane	f
Dorothée	f
Edgard	m
Édith	f
Edmond	m
Édouard	m
Edwige	f
Eléonore	f
Éliane	f
Élie	m
Élisabeth	f
Élise	f
Élodie	f
Eloi	m
Éloïse	f
Elvire	f
Emeline	f
Émeric	m
Émile	m
Émilie	f
Émilien	m
Emmanuelle	f
Ermenegilde	m
Esmé	mf
Esmée	f
Étienne	m
Eugène	m
Eugénie	f
Eulalie	f
Eustache	m
Évariste	m
Ève	f
Évelyne	f
Evrard	m
Fabien	m
Fabienne	f
Fabrice	m
Faustine	f
Félicie	f
Felicien	m
Felicienne	f
Fernand	m
Fernande	f
Fiacre	m
Fifi	f
Firmin	m
Flavie	f
Flore	f
Florent	m
Florentin	m
Florianne	f
Florine	f
France	f
Francette	f
Francisque	m
Franck	m
François	m
Françoise	f
Frédéric	m
Frédérique	f
Fulbert	m
Gaétan	m
Gaetane	f
Gaspard	m
Gaston	m
Gaubert	m
Gautier	m
Geneviève	f
Geoffroy	m
Georges	m
Georgette	f
Georgine	f
Gérald	m
Géraldine	f
Gérard	m
Géraud	m
Germain	m
Germaine	f
Gervais	m
Ghislain	m
Ghislaine	f
Ghyslain	m
Gigi	f
Gilberte	f
Gilles	m
Gisèle	f
Gratien	m
Grégoire	m
Guenièvre	f
Guillaume	m
Gustave	m
Hélène	f
Héloïse	f
Hercule	m
Hervé	m
Hilaire	m
Hippolyte	m
Honoré	m
Honorine	f
Hugues	m
Huguette	f
Hyacinthe	mf
Ignace	m
Inès	f
Irène	f
Irénée	m
Jacinthe	f
Jacques	m
Jasmin	m
Jean	m
Jean Baptiste	m
Jean Marie	m
Jeannot	m
Jérémie	m
Jérôme	m
Joceline	f
Joël	m
Joëlle	f
Josée	f
Josèphe	f
Joséphine	f
Josette	f
Josiane	f
Jourdain	m
Jules	m
Julien	m
Julienne	f
Juliette	f
Juste	m
Laure	f
Laurence	f
Laurent	m
Laurentin	m
Laurentine	f
Laurette	f
Lazare	m
Léa	f
Léandre	m
Léo	m
Léon	m
Léonard	m
Léonce	m
Léone	f
Léonide	mf
Léonie	f
Léonne	f
Léontine	f
Léopold	m
Liliane	f
Lionel	m
Lorette	f
Lothaire	m
Loup	m
Luc	m
Lucette	f
Lucien	m
Lucienne	f
Lucinde	f
Lucrèce	mf
Ludivine	f
Ludovic	m
Lydie	f
Magali	f
Mahaut	f
Marceline	f
Marcelle	f
Marcellette	f
Marcellin	m
Marcelline	f
Margaux	f
Margot	f
Marguerite	f
Marielle	f
Mariette	f
Marilène	f
Marine	f
Marise	f
Marjolaine	f
Marlène	f
Martine	f
Mathieu	m
Matthieu	m
Maxence	m
Maxime	m
Maximilien	m
Maximilienne	f
Mélanie	f
Mélisande	f
Mélissa	f
Michèle	f
Micheline	f
Mireille	f
Modeste	m
Modestine	m
Monique	f
Morgane	f
Myriam	f
Nadine	f
Narcisse	m
Natacha	f
Nazaire	m
Nicéphore	m
Nicodème	m
Nicolas	m
Nicolette	f
Ninette	f
Ninon	f
Noël	m
Noèle	f
Noella	f
Noëlle	f
Noémie	f
Océane	f
Odette	f
Odile	f
Olympe	f
Onésime	m
Oriane	f
Orianne	f
Osanne	mf
Ozanne	mf
Pascale	f
Pascaline	f
Patrice	m
Paule	f
Paulette	f
Pénélope	f
Perrine	f
Pétronille	f
Philibert	m
Philippe	m
Philippine	f
Pierre	m
Pierrette	f
Placide	f
Pons	m
Rainier	m
Raoul	m
Raphaël	m
Raphaëlle	f
Raymonde	f
Rébecca	f
Régine	f
Régis	m
Reine	f
Rémi	m
Rémy	m
Renaud	m
Reynaud	m
Rodolphe	m
Rodrigue	m
Rolande	f
Romain	m
Romane	f
Rosaire	m
Rosalie	f
Rosemonde	f
Rosette	f
Rosine	f
Sacha	mf
Sandrine	f
Sébastien	m
Sébastienne	f
Séraphin	m
Seraphine	f
Serge	m
Sévère	m
Séverin	m
Sévérine	f
Sidonie	f
Solange	f
Solène	f
Stéphane	m
Stéphanie	f
Suzette	f
Sylvain	m
Sylvaine	f
Sylvestre	m
Sylviane	f
Sylvianne	f
Sylvie	f
Tatienne	f
Telesphore	m
Theirn	m
Théo	m
Théodore	m
Théophile	m
Thérèse	f
Thibault	m
Thierry	m
Timothée	m
Toinette	f
Toussaint	m
Urbain	m
Valentine	f
Valère	m
Valérie	f
Valéry	m
Vérène	f
Véronique	f
Vespasien	m
Victoire	f
Victorine	f
Vienne	f
Violette	f
Virginie	f
Vivianne	f
Vivien	m
Vivienne	f
Yolande	f
Yseult	f
Yves	m
Yvon	m
Zacharie	m
Zoé	f
Aldric	m
Gaël	m
Gaëlle	f
Gwenaël	m
Gwenaëlle	f
Loïc	m
Maël	m
Maëlle	f
Maëlys	f
Agnès	f
Marc	m
Lucie	f
Olivie	f
Marie	f
Augustin	m
Cécile	f
Godelieve	f
Manon	f
Nicoline	f
Olivier	m
Renée	f
Fleur	f
Adeline	f
Aline	f
Annette	f
Bernadette	f
Blanche	f
Caroline	f
Catherine	f
Clair	m
Claire	f
Claude	mf
Corinne	f
Danielle	f
Denise	f
Diane	f
Dianne	f
Francine	f
Gabrielle	f
Hortense	f
Jacqueline	f
Jeanette	f
Jeanine	f
Jeanne	f
Jeannette	f
Jeannine	f
Julie	f
Justine	f
Lisette	f
Lucile	f
Lucille	f
Madeleine	f
Marion	f
Michelle	f
Prosper	m
Quentin	m
Romaine	f
Roxane	f
Simone	f
Suzanne	f
Yvette	f
Yvonne	f
Giselle	f
Boniface	m
Constant	m
Ginette	f
Bertrand	m
Chantal	f
Louis	m
Louise	f
Marilou	f
Nicole	f
Isabelle	f
Natalie	f
Sophie	f
Marianne	f
Pauline	f
Charlotte	f
Christine	f
Nadia	f
Anne	f
Henri	m
Alexandrine	f
Ariane	f
Augustine	f
Juliane	f
Marthe	f
Michel	m
Nathalie	f
Pascal	m
Sabine	f
Henriette	f
Mathilde	f
Ernestine	f
Agathe	f
Joachim	m
Mathias	m
Gabriel	m
René	m
Achille	m
Roch	m
André	m
Odilon	m
Salomé	f
Alexandre	m
Donat	m
Constantin	m
Marin	m
Marcel	m
Denis	m
Lise	f
Salomon	m
Félix	m
César	m
Noé	m
Lambert	m
Christiane	f
Hermine	f
Mathis	m
Sibylle	f
Sybille	f
Ulrich	m
Ferdinand	m
Alban	m
Humbert	m
Raphael	m
Alexis	mf
Florian	m
Alexandra	f
Iris	f
Matthias	m
Patrick	m
Enzo	m
Luce	f
Fabiola	f
Laetitia	f
Maeva	f
Cosme	m
Anaïs	f
Dimitri	m
Nina	f
Valentin	m
Josue	m
Isabel	f
Débora	f
Gwendoline	f
Morgan	mf
Tristan	m
