Femke	f
Gerrit	m
Joris	m
Ludo	m
Siemen	m
Wibo	m
Wob	m
Wubbe	m
Wiebe	m
Elke	f
Ane	m
Anne	mf
Bent	m
Dieuwe	m
Dieuwke	f
Fedde	m
Friso	m
Japik	m
Klaes	m
Lubbert	m
Nienke	f
Nine	f
Rokus	m
Siet	m
Sietse	m
Sikke	m
Wate	m
Watse	m
Wide	m
Jelle	m
Jeltje	f
Jeltsje	f
Lourens	m
Minke	mf
Sjoerd	m
Tiede	m
Tjaard	m
Tjeerd	m
Meine	m
Inka	f
Maike	f
Mareike	f
Kay (3)	m
Kai	m
Eilert	m
Heike	mf
Heiko	m
Maria	mf
