Xabier	m
Alexandre	m
Alberte	m
Aleixo	m
Antía	f
Antón	m
Anxo	m
Bieito	m
Cibrán	m
Estevo	m
Lía	f
Lois	m
Noela	f
Roi	m
Sabela	f
Uxía	f
Uxío	m
Vitor	m
Xesús	m
Xoán	m
Xoana	f
Xosé	m
Xurxo	m
Carme	f
Artur	m
Catarina	f
Lino	m
Afonso	m
Bartolomeu	m
Dores	f
Iria	f
Margarida	f
Nicolau	m
Paulo	m
María	f
Rodrigo	m
Iago	m
