Melitta	f
Cornelius	m
Julius	m
Marcellus	m
Marius	m
Jonas	m
Timotheus	m
Tobias	m
Boris	m
Dana	f
Dominik	m
Malthe	m
Thorben	m
Torben	m
Else	f
Hanne	f
Karen	f
Frej	m
Freja	f
Malte	m
Wiebe	m
Aleida	f
Annemarie	f
Elma	f
Lammert	m
Margaretha	f
Menno	m
Saskia	f
Wim	m
Petrus	m
Jana	f
Dirk	m
Wilhelmina	f
Juliana	f
Hendrik	m
Hannes	m
Mirjam	f
Amalia	f
Elke	f
Alida	f
Petronella	f
Jan	m
Philippa	f
Alexia	f
Katherina	f
Isolde	f
Linda	f
Georgina	f
Gilbert	m
Joseph	m
Richard	m
Benjamin	m
Adam	m
Thomas	m
Paul	m
Sarah	f
Roland	m
Christian	m
Martin	m
Albert	m
Roger	m
Arthur	m
Emma	f
Robert	m
Simon	m
Alfred	m
Cara	f
Carina	f
Evelyn	mf
Gerald	m
Josephine	f
Katharine	f
Lara	f
Leona	f
Marvin	m
Stephanie	f
Arnold	m
Bertram	m
Conrad	m
Waldo	m
Corinna	f
Doris	f
Oswald	m
Salome	f
Abigail	f
Lydia	f
Michael	m
Andrea	f
Dennis	m
Gertrude	f
Melanie	f
Willy	mf
Frank	m
Hubert	m
Claudia	f
Beatrix	f
Aloysius	m
Agnes	f
Hilda	f
Alexander	m
Lisa	f
Peter	m
Tim	m
Herbert	m
Elmo	m
Flora	f
Philomena	f
Edmund	m
Ada	f
Leon	m
Corina	f
Selma	f
Theresa	f
Ruth	f
Christina	f
Edith	f
Ina	f
Jonathan	m
Ida	f
Julia	f
Walter	m
Oliver	m
Katrina	f
Elsa	f
Sophia	f
Judith	f
Hannah	f
Rachel	f
Daniel	m
David	m
Kevin	m
Barbara	f
Sabrina	f
Cornelia	f
Angela	f
Anna	f
Regina	f
Olivia	f
Irene	f
Cecilia	f
Julian	m
Adrian	m
Ralph	m
Sylvia	f
Ursula	f
Rita	f
Amelia	f
Diana	f
Laura	f
Patricia	f
Amanda	f
Marie	f
Isabelle	f
Natalie	f
Sophie	f
Marianne	f
Pauline	f
Charlotte	f
Christine	f
Anne	f
Alexandrine	f
Ariane	f
Augustine	f
Juliane	f
Marthe	f
Michel	m
Nathalie	f
Pascal	m
Sabine	f
Henriette	f
Mathilde	f
Ernestine	f
Agathe	f
Joachim	m
Mathias	m
Gabriel	m
René	m
Marcel	m
Denis	m
Meine	m
Maike	f
Mareike	f
Kay (3)	m
Kai	m
Achim	m
Albrecht	m
Aleit	f
Aloisia	f
Amalie	f
Amand	m
Amelie	f
Anelie	f
Anina	f
Annegret	f
Armin	m
Arndt	m
Arne	m
Baptist	m
Bartholomäus	m
Bastian	m
Beate	f
Benno	m
Bernd	m
Bettina	f
Bonifaz	m
Cäcilia	f
Cäcilie	f
Carolin	f
Carsten	m
Cathrin	f
Christel	f
Christoph	m
Cord	m
Cordula	f
Detlef	m
Didi	m
Dierk	m
Dieter	m
Dietfried	m
Diethelm	m
Dietlinde	f
Dietmar	m
Dietrich	m
Dörthe	f
Eckart	m
Eckbert	m
Eckehard	m
Eckhard	m
Eckhart	m
Egon	m
Ekkehardt	m
Eleonore	f
Elfriede	f
Elli	f
Engel	m
Erdmann	m
Erhard	m
Erich	m
Erna	f
Evert	m
Felicie	f
Ferdi	m
Fester	m
Franz	m
Fränze	f
Franzi	f
Franziska	f
Frauke	f
Friede	f
Friedemann	m
Friederike	f
Friedhelm	m
Friedhold	m
Friedrich	m
Fritz	m
Fritzi	f
Gabriele	f
Gebbert	m
Gebhard	m
Gereon	m
Gerfried	m
Gerhardt	m
Gerlinde	f
Gero	m
Gertraud	f
Gisa	f
Gitta	f
Gitte	f
Gottfried	m
Gotthard	m
Gotthilf	m
Gotthold	m
Gottlieb	m
Gottlob	m
Gottschalk	m
Gratia	f
Gretel	f
Gundula	f
Günter	m
Gunter	m
Gunther	m
Guntram	m
Hagan	m
Hanke	m
Hannelore	f
Hartmann	m
Hedwig	f
Heida	f
Heilwig	f
Heiner	m
Heinrike	f
Heinz	m
Helfried	m
Helma	f
Helmfrid	m
Helmfried	m
Helmine	f
Helmut	m
Helmuth	m
Heribert	m
Hermann	m
Hermenegild	m
Hermia	f
Herta	f
Hertha	f
Hilbert	m
Hildebert	m
Hiltraud	f
Hiltrud	f
Hiltrude	f
Hinrich	m
Horst	m
Huppert	m
Ignatz	m
Ilsa	f
Imke	f
Imma	f
Ingo	m
Irmgard	f
Irmhild	f
Irmingard	f
Irmtraud	f
Irmtrud	f
Isabell	f
Ivonne	f
Jeremias	m
Jochen	m
Jochim	m
Johann	m
Jörg	m
Josefine	f
Jürgen	m
Jutta	f
Jutte	f
Karlmann	m
Karsten	m
Kasimir	m
Kaspar	m
Katarine	f
Käthe	f
Kathrin	f
Katinka	f
Kayetan	m
Kinge	f
Kora	f
Korbinian	m
Körbl	m
Kord	m
Kreszentia	f
Kreszenz	f
Kriemhilde	f
Krimhilde	f
Kristiane	f
Kunibert	m
Kunigunde	f
Kuno	m
Kurt	m
Leberecht	m
Leni	f
Lenz	m
Leonhard	m
Leonie	f
Leonore	f
Liane	f
Liesa	f
Liesel	f
Lieselotte	f
Liesl	f
Lili	f
Lilli	f
Lilo	f
Lisbeth	f
Lore	f
Lorenz	m
Lothar	m
Ludolf	m
Ludwig	m
Luise	f
Luitgard	f
Luitger	m
Luitpold	m
Lulu	f
Lutgard	f
Lutz	m
Lys	f
Lysanne	f
Manfried	m
Margarete	f
Margrit	f
Mariele	f
Marlis	f
Marwin	m
Marzell	m
Matthäus	m
Mechthild	f
Mechtilde	f
Meinard	m
Meinhard	m
Meinrad	m
Merten	m
Mitzi	f
Moritz	m
Mose	m
Nele	f
Nickolaus	m
Niklaus	m
Nikolaus	m
Ortrun	f
Ortwin	m
Ottilie	f
Ottokar	m
Pankraz	m
Parsifal	m
Philipp	m
Poldi	m
Raffael	m
Raffaela	f
Raimunde	f
Rambert	m
Raphaela	f
Regine	f
Reimund	m
Rein	m
Reinhild	f
Reinhilde	f
Reto	m
Rike	f
Roswitha	f
Rüdiger	m
Sascha	mf
Schwanhild	f
Senta	f
Sepp	m
Seppel	m
Siegbert	m
Sieghard	m
Sieghild	f
Siegmund	m
Sigi	mf
Sigiswald	m
Silke	f
Sonje	f
Steffi	f
Stephan	m
Suse	f
Susi	f
Svenja	f
Swanhild	f
Swanhilda	f
Swanhilde	f
Tabea	f
Theda	f
Till	m
Tillo	m
Traugott	m
Udo	m
Urs	m
Ursel	f
Uschi	f
Ute	f
Utz	m
Uwe	m
Valeska	f
Veit	m
Vester	m
Vinzent	m
Vinzenz	m
Volker	m
Vreni	f
Walburga	f
Waltraud	f
Wenzel	m
Wenzeslaus	m
Werther	m
Wibeke	f
Wiebke	f
Wilfried	m
Wilhelmine	f
Willi	m
Winfried	m
Wolfram	m
Xaver	m
Zella	f
Zenzi	f
Zilla	f
Ziska	f
Ava (3)	f
Eberhard	m
Ekkehard	m
Emmerich	m
Engelbert	m
Ewald	m
Gerhild	f
Gernot	m
Gerold	m
Gertrud	f
Gerulf	m
Gervas	m
Gisbert	m
Hartmut	m
Hartwig	m
Hartwin	m
Heinrich	m
Hildebrand	m
Lanzo	m
Oda	f
Raimund	m
Rainer	m
Reiner	m
Reinhard	m
Reinhold	m
Sigismund	m
Walther	m
Wolfgang	m
Hieronymus	m
Nicolaus	m
Caecilia	f
Regula	f
Alois	m
Benedikta	f
Koloman	m
Nikola	f
Alena	f
Claus	m
Klaus	m
Liselotte	f
Margarethe	f
Ulrike	f
Sofie	f
Christa	f
Magdalene	f
Grete	f
Henning	m
Karoline	f
Lene	f
Steffen	m
Klemens	m
Adelbert	m
Adelheid	f
Anke	f
Annelies	f
Anneliese	f
Antje	f
Ernst	m
Geert	m
Gerd	m
Gerda	f
Gert	m
Hedy	f
Hilde	f
Ilse	f
Jochem	m
Klaas	m
Lies	f
Liese	f
Ludger	m
Meike	f
Meino	m
Renate	f
Ria	f
Rochus	m
Wendel	m
Yvo	m
Alwin	m
Erwin	m
Filibert	m
Ivo	m
Wendelin	m
Anika	f
Lotte	f
Stefanie	f
Rebekka	f
Dorothea	f
Wilma	f
Leo	m
Rupert	m
Leopold	m
Lambert	m
Isa	f
Justus	m
Manfred	m
Alfons	m
Fabian	m
Hans	m
Werner	m
Bernhard	m
Adolf	m
Magda	f
Elisabeth	f
Felix	m
Heidi	f
Johannes	m
Rudolf	m
Helena	f
Lea	f
Gisela	f
Theresia	f
Gerhard	m
Magdalena	f
Frieda	f
Gretchen	f
Jasmin	f
Krista	f
Marlene	f
Romy	f
Trudi	f
Jessika	f
Anselm	m
Barnabas	m
Bertha	f
Norbert	m
Paula	f
Adele	f
Maximilian	m
Max	m
Sebastian	m
Silvester	m
Markus	m
Minna	f
Heino	m
Tanja	f
Christiane	f
Hermine	f
Mathis	m
Sibylle	f
Sybille	f
Ulrich	m
Ferdinand	m
Alban	m
Humbert	m
Raphael	m
Alexis	mf
Heike	mf
Heiko	m
Günther	m
Kriemhild	f
Siegfried	m
Sieglinde	f
Wieland	m
Andreas	m
Immanuel	m
Wolf	m
Rudi	m
Irma	f
Konstantin	m
Baldur	m
Augusta	f
Alina	f
Anselma	f
Elisa	f
Clemens	m
Crescentia	f
Felicitas	f
Verena	f
Angelika	f
Wilhelm	m
Daniela	f
Florian	m
August	m
Artur	m
Aurel	m
Eugen	m
Gabi	mf
Benedikt	m
Isidor	m
Eduard	m
Anton	m
Annelie	f
Ebba	f
Ebbe	m
Emilie	f
Gunda	f
Hanne	f
Henrike	f
Hildegarde	f
Karla	f
Katharina	f
Meta	f
Rosemarie	f
Severin	m
Susann	f
Susanne	f
Therese	f
Viktoria	f
Ansgar	m
Hildegard	f
Helene	f
Josef	m
Emil	m
Theodor	m
Monika	f
Elise	f
Otto	m
Alexandra	f
Johanna	f
Martina	f
Stefan	m
Jakob	m
Carl	m
Rolf	m
Sigmund	m
Thea	f
Ralf	m
Karl	m
Georg	m
Ulrika	f
Hanna	f
Sonja	f
Katarina	f
Lukas	m
Waldemar	m
Konrad	m
Maja	f
Maja	f
Margareta	f
Gregor	m
Katja	f
Nadja	f
Marita	f
Katrin	f
Kerstin	f
Mattias	m
Michaela	f
Falk	m
Linus	m
Phyllis	f
Iris	f
Thekla	f
Petra	f
Matthias	m
Sibylla	f
Elias	m
Sara	f
Miriam	f
Marcell	m
Ilona	f
Patrick	m
Nora	f
Kilian	m
Sandra	f
Angelina	f
Carola	f
Ferdinanda	f
Guido	m
Marcella	f
Zita	f
Debora	f
Eleonora	f
Lucia	f
Albertina	f
Clara	f
Maria	mf
Severina	f
Carla	f
Adelina	f
Pia	f
Antonia	f
Fabiola	f
Isabella	f
Eva	f
Aurora	f
Renata	f
Marina	f
Silvia	f
Valeria	f
Gudrun	f
Olaf	m
Sofia	f
Berta	f
Janina	f
Witold	m
Alfreda	f
Beata	f
Karolina	f
Gabriela	f
Veronika	f
Vera	f
Isaak	m
Nina	f
Roman	m
Olga	f
Mia	f
Erik	m
Erika	f
Hanna	f
Astrid	f
Axel	m
Carina	f
Christin	f
Dagmar	f
Gustav	m
Harald	m
Helge	m
Hella	f
Hulda	f
Ingeborg	f
Ingolf	m
Ingrid	f
Jonatan	m
Knut	m
Lennart	m
Thora	f
Helga	f
Inge	mf
Sven	m
Johan	m
Karin	f
Kristin	f
Valentin	m
Viktor	m
Henrik	m
Kristine	f
Oskar	m
Emanuel	m
Inga	f
Lena	f
Klara	f
Karina	f
Kristina	f
Tatjana	f
Ricarda	f
Vilma	f
Rosa	f
Hugo	m
Isabel	f
Manuel	m
Rafael	m
Teresa	f
Manuela	f
Thorsten	m
Torsten	m
Annika	f
Gustaf	m
Sören	m
Björn	m
Greta	f
Rut	f
Catrin	f
