Thomas	m
Georgia	f
Nikolas	m
Theodora	f
Zoe	f
Silas	m
Sophia	f
Anna	f
Martha	f
Agathe	f
Alexis	mf
Andreas	m
Alexandra	f
Anargyros	m
Angelos	m
Apostolis	m
Apostolos	m
Argyris	m
Chara	f
Charalampos	m
Chryssa	f
Demi	f
Despina	f
Despoina	f
Diamantina	f
Diamanto	m
Dimitrios	m
Dimitris	m
Dimosthenis	m
Efimia	f
Efrosyni	f
Efstathios	m
Efthalia	f
Eleftheria	f
Eleftherios	m
Eleni	f
Elisavet	f
Elpida	f
Emmanouil	m
Evangelos	m
Evdokia	f
Evgenia	f
Filippos	m
Fotios	m
Fotis	m
Gerasimos	m
Glykeria	f
Gus	m
Ioannis	m
Katina	f
Konstantinos	m
Korina	f
Kyriake	f
Kyriaki	f
Lavrentios	m
Lefteris	m
Louiza	f
Marios	m
Nana	f
Natasa	f
Nicolaos	m
Nikoleta	f
Nomiki	m
Panagiota	f
Panagiotakis	m
Panagiotis	m
Panayiotis	m
Panos	m
Paraskevas	m
Paraskeve	f
Paraskevi	f
Pavlos	m
Serafeim	m
Sotiria	f
Sotirios	m
Sotiris	m
Spiro	m
Spiros	m
Spyridoula	f
Spyro	m
Spyros	m
Stamatia	f
Stamatios	m
Stamatis	m
Stathis	m
Stavros	m
Stefanos	m
Stelios	m
Stylianos	m
Takis	m
Tasia	f
Tasoula	f
Thanasis	m
Thanos	m
Vangelis	m
Vasiliki	f
Vasilios	m
Vasilis	m
Vassilis	m
Vlasis	m
Vlassis	m
Xene	f
Yanni	m
Yannis	m
Yianni	m
Yiannis	m
Yiorgos	m
Yorgos	m
Zenovia	f
Zinovia	f
Agape	f
Agapios	m
Aikaterine	f
Akakios	m
Anastasios	m
Aniketos	m
Athanasia	f
Athanasios	m
Chrysanthe	f
Chrysanthos	m
Demetrios	m
Dionysios	m
Georgios	m
Kyriakos	m
Leonidas	m
Photios	m
Theodoros	m
Theophania	f
Theophylaktos	m
Tryphon	m
Xenia	f
Ioanna	f
Ioannes	m
Mikhael	m
Petros	m
Alexandros	m
Anastasia	f
Elene	f
Thekla	f
Petra	f
Matthias	m
Sibylla	f
Dorotheos	m
Gregorios	m
Elias	m
Spiridon	m
Spyridon	m
Olympia	f
Sara	f
Marianna	f
Maria	mf
Marina	f
Katerina	f
Sofia	f
Gavriil	m
Varvara	f
Filippa	f
Iosif	m
