Hector	m
Jason	m
Alexander	m
Cassandra	f
Cynthia	f
Phoebe	f
Irene	f
Helena	f
Acantha	f
Achilles	m
Aegle	f
Aeolus	m
Aeson	m
Aglaea	f
Ajax	m
Alcippe	f
Alcyone	f
Alecto	f
Althea	f
Amalthea	f
Anthea	f
Apollo	m
Arethusa	f
Argus	m
Aristaeus	m
Astraea	f
Atalanta	f
Bacchus	m
Calliope	f
Callisto	f
Calypso	f
Carme	f
Cassiopea	f
Cassiopeia	f
Castor	m
Cephalus	m
Cepheus	m
Cerberus	m
Circe	f
Clotho	f
Clytemnestra	f
Clytia	f
Coeus	m
Crius	m
Cronus	m
Daedalus	m
Damocles	m
Dionysus	m
Electra	f
Erebus	m
Europa	f
Eurydice	f
Evadne	f
Gaea	f
Glaucus	m
Hades	m
Halcyone	f
Hecate	f
Hephaestus	m
Hippolyta	f
Iacchus	m
Icarus	m
Ilithyia	f
Iphigenia	f
Jocasta	f
Leander	m
Medea	f
Medusa	f
Megaera	f
Menelaus	m
Neoptolemus	m
Oceanus	m
Oedipus	m
Oenone	f
Patroclus	m
Pegasus	m
Phaedra	f
Phoebus	m
Phrixus	m
Polyhymnia	f
Polyxena	f
Thalia	f
Urania	f
Uranus	m
Hyacinthus	m
Lycurgus	m
Pyrrhus	m
Linus	m
Clio	f
Narcissus	m
Evander	m
Pluto	m
Rhea	f
Selena	f
