Aristodemos	m
Elpis	f
Nikephoros	mf
Melissa	f
Chloe	f
Doris	f
Delia	f
Helene	f
Alexandra	f
Achilleus	m
Adonis	m
Adrasteia	f
Adrastos	m
Aella	f
Agamemnon	m
Agaue	f
Aglaia	f
Aias	m
Aigle	f
Aineias	m
Aiolos	m
Alkyone	f
Andromache	f
Andromeda	f
Antigone	f
Antiope	f
Aoide	f
Aphrodite	f
Apollon	m
Arachne	f
Ares	m
Ariadne	f
Artemis	f
Asklepios	m
Athena	f
Athene	f
Atlas	m
Atropos	f
Charon	m
Chloris	f
Chryseis	f
Chryses	m
Danaë	f
Dardanos	m
Deimos	m
Demeter	f
Dike	f
Diomedes	m
Dione	f
Dionysos	m
Echo	f
Elektra	f
Endymion	m
Enyo	f
Eos	f
Epimetheus	m
Erato	f
Erebos	m
Eris	f
Eros	m
Euadne	f
Euandros	m
Eudora	f
Eunomia	f
Euphrosyne	f
Europe	f
Eurydike	f
Euterpe	f
Harmonia	f
Hebe	f
Hekate	f
Hektor	m
Helios	m
Helle	f
Hephaistos	m
Hera	f
Herakles	m
Hermes	m
Hermione	f
Hero	f
Hestia	f
Hippolyte	f
Hyperion	m
Ianthe	f
Iapetos	m
Iason	m
Io	f
Iole	f
Iphigeneia	f
Ismene	f
Kalliope	f
Kalypso	f
Karme	f
Kassiopeia	f
Kirke	f
Kleio	f
Klotho	f
Klytië	f
Koios	m
Korë	f
Kreios	m
Kronos	m
Kynthia	f
Lachesis	f
Leandros	m
Leda	f
Leto	f
Linos	m
Melaina	f
Melanthios	m
Melete	f
Melia	f
Melpomene	f
Menelaos	m
Mentor	m
Midas	m
Mneme	f
Mnemosyne	f
Morpheus	m
Narkissos	m
Nemesis	f
Neoptolemos	m
Nephele	f
Nyx	f
Odysseus	m
Oidipous	m
Oinone	f
Okeanos	m
Orestes	m
Orion	m
Orpheus	m
Ourania	f
Ouranos	m
Pallas	mf
Pan	m
Pandora	f
Paris	m
Parthenia	f
Parthenope	f
Patroklos	m
Persephone	f
Perseus	m
Philomela	f
Phobos	m
Phrixos	m
Polydeukes	m
Polymnia	f
Poseidon	m
Praxis	f
Prometheus	m
Proteus	m
Psyche	f
Rheia	f
Sarpedon	m
Selene	f
Semele	f
Terpsichore	f
Tethys	f
Thanatos	m
Theia	f
Themis	f
Theseus	m
Tisiphone	f
Zephyrus	m
Zeus	m
Eirene	f
Hippolytos	m
Hyakinthos	m
Kallisto	f
Ligeia	f
Nike	f
Phoibos	m
Pyrrhos	m
Xanthe	f
Zephyros	m
Phoibe	f
Nereus	m
Damon	m
Ione	f
Penelope	f
Kassandra	f
Daphne	f
Phyllis	f
Iris	f
Gaia	f
Maia	f
Nestor	m
Alexandros	m
Larisa	f
