Ezra	m
Gideon	m
Ira	m
Amos	m
Adina	mf
Barak	m
Baruch	m
Boaz	m
Hadassah	f
Hillel	m
Ithamar	m
Melech	m
Menahem	m
Meshullam	m
Michal	f
Mordecai	m
Naamah	f
Omri	m
Shiphrah	f
Uri	m
Uriel	m
Zipporah	f
Arieh	m
Asa	m
Atarah	f
Ehud	m
Nogah	mf
Uzzi	m
Uzziel	m
Eliezer	m
Malachi	m
Reuben	m
Asher	m
Levi	m
Ariel	mf
Moss	m
Adam	m
Sarah	f
Isidore	m
Leon	m
Abe	m
Deborah	f
Elijah	m
Naomi	f
Eli	m
Leah	f
Abraham	m
Hannah	f
Rachel	f
Daniel	m
David	m
Immanuel	m
Wolf	m
Adara	f
Adena	f
Adi	mf
Adva	f
Ahava	f
Ahuva	f
Akiba	m
Akiva	m
Aliya	f
Aliyah	f
Aliza	f
Alon	m
Alona	f
Amir	m
Amira	f
Amit	m
Ari	m
Arik	m
Aryeh	m
Atara	f
Avi	m
Avia	f
Avigail	f
Avishai	m
Aviv	m
Aviva	f
Aviya	mf
Ayala	f
Ayelet	f
Ayla	f
Bashe	f
Basia	f
Basya	f
Batel	f
Batya	f
Batyah	f
Beracha	f
Bosmat	f
Chaim	m
Chanah	f
Chava	f
Chaya	f
Chayim	m
Chayyim	m
Chesed	mf
Dalia (3)	f
Dalya	f
Danya	f
Dara	f
Dassah	f
Dekel	m
Deror	m
Derorit	f
Dikla	mf
Dor	mf
Dori	m
Dorit	f
Doron	m
Dov	m
Dror	m
Drorit	f
Dvorah	f
Elah	f
Eli	m
Eliana	f
Elior	m
Eliora	f
Elisheva	f
Elkan	m
Elke	f
Erez	m
Estee	f
Eyal	m
Eytan	m
Gal	mf
Galia	f
Galit	f
Gavriel	m
Gil (3)	m
Gilad	m
Gilah	f
Goldie	f
Hadar	mf
Hadas	f
Haim	m
Hava	f
Hayim	m
Hayyim	m
Hebel	m
Hed	mf
Herut	f
Hyam	m
Idan	m
Idriya	f
Ilan	m
Ilana	f
Ilanit	f
Inbal	f
Irit	f
Itamar	m
Itzhak	m
Jaffe	mf
Kelila	f
Keren	f
Keshet	mf
Lavi	m
Lev	m
Liat	f
Lior	mf
Liora	f
Liorit	f
Liron	mf
Livna	f
Livnat	f
Maayan	f
Malka	f
Maor	m
Margalit	f
Margalita	f
Marganita	f
Marni	f
Marnie	f
Matan	m
Mattithyahu	m
Maya (3)	f
Maytal	f
Meir	m
Meira	f
Meirit	f
Meital	f
Melek	m
Menachem	m
Menashe	m
Menuha	f
Merav	f
Meshulam	m
Mica	f
Mordechai	m
Nadav	m
Nahal	f
Nava	f
Nessa	f
Neta	f
Nir	m
Nissa	f
Nitza	f
Niv	m
Noam	mf
Noga	mf
Nurit	f
Ofer	m
Ofra	mf
Omer	m
Ora	f
Orah	f
Oren	m
Ori	m
Orit	f
Orli	f
Orly	f
Orna	f
Osher	m
Ovadia	m
Oved	m
Oz	m
Pinchas	m
Raanan	m
Ravid	mf
Raziela	f
Reut	f
Rina	f
Riva	f
Rivka	f
Roi	m
Ron	mf
Ronen	m
Roni	f
Ronit	f
Rotem	mf
Sagi	m
Sarit	f
Shachar	mf
Shahar	mf
Shai	m
Shalom	m
Shamira	f
Shani	f
Shay	mf
Sheraga	m
Shifra	f
Shir	f
Shira	f
Shiri	f
Shlomo	m
Shmuel	m
Shoshana	f
Shraga	m
Shulamit	f
Shulamith	f
Sigal	f
Simcha	mf
Smadar	f
Sol	m
Solly	m
Tahlia	f
Tal	mf
Talia	f
Talya	f
Tamir	m
Tehila	f
Tikva	f
Tomer	m
Tova	f
Tovah	f
Tovia	mf
Tuvya	m
Tzafrir	m
Tziporah	f
Tzivya	f
Tzufit	f
Tzvi	m
Udi	m
Uzi	m
Varda	f
Vardah	f
Vered	f
Yachna	f
Yaen	f
Yafa	f
Yafe	mf
Yaffa	f
Yaffe	mf
Yakira	f
Yaniv	m
Yarden	mf
Yardena	f
Yaron	m
Yarona	f
Yehiel	m
Yoni	m
Yonina	f
Yonit	f
Zakiah	f
Zeev	m
Zev	m
Ziv	mf
Ziva	f
Zivit	f
Zohar	mf
Zvi	m
Binyamin	m
Shulammite	f
Zion	m
Efraim	m
Noa	f
Aharon	m
Anat	mf
Avidan	m
Aviram	m
Avishag	f
Avner	m
Avraham	m
Avram	m
Channah	f
Devorah	f
Efrat	f
Eiran	m
Eitan	m
Eliyahu	m
Hevel	m
Iyov	m
Mattityahu	m
Mikha'el	m
Moshe	m
Natan	m
Noach	m
Reuven	m
Shimon	m
Shimshon	m
Shoshannah	f
Yaakov	m
Yachin	m
Yael	f
Yair	m
Yechezkel	m
Yehoshua	m
Yehudah	m
Yehudi	m
Yehudit	f
Yemima	f
Yishai	m
Yisra'el	m
Yissakhar	m
Yitzhak	m
Yoav	m
Yochanan	m
Yocheved	f
Yoel	m
Yonah	m
Yonatan	m
Yoram	m
Yosef	m
Yuval	m
Diklah	mf
Tamar	f
Miriam	f
Yakov	m
