Valli	f
Aditi	f
Aditya	m
Agni	m
Ananta	mf
Anil	m
Aniruddha	m
Arjuna	m
Aruna	m
Arundhati	f
Bala	mf
Baladeva	m
Bharata	m
Bhaskara	m
Chandra	mf
Damayanti	f
Damodara	m
Devaraja	m
Devi	f
Dilipa	m
Dipaka	m
Draupadi	f
Drupada	m
Durga	f
Ganesha	m
Gauri	f
Girisha	m
Gopala	m
Gopinatha	m
Gotama	m
Govinda	m
Hari	m
Harisha	m
Indira	f
Indra	m
Indrajit	m
Indrani	f
Jagannatha	m
Jaya	f
Jayanti	f
Kali	f
Kalyani	f
Kama	m
Kamala	f
Kanti	f
Kapila	m
Karna	m
Krishna	m
Kumara	m
Kumari	f
Lakshmana	m
Lakshmi	f
Lalita	f
Madhava	m
Madhavi	f
Mahesha	m
Mani	m
Manu	m
Maya	f
Mina	f
Mohana	mf
Mohini	f
Mukesha	m
Murali	m
Nala	m
Nanda	m
Narayana	m
Padma	mf
Padmavati	f
Pankaja	m
Partha	m
Parvati	f
Pitambara	m
Prabhu	m
Pramoda	m
Pritha	f
Priya	f
Purushottama	m
Radha	f
Raghu	m
Rajani	f
Rama	m
Ramachandra	m
Ramesha	m
Rati	f
Ravi	m
Reva	f
Rukmini	f
Sachin	m
Sandhya	f
Sanjaya	m
Saraswati	f
Sati	f
Savitr	m
Savitri	f
Shailaja	f
Shakti	f
Shankara	m
Shanta	f
Shantanu	m
Shiva	m
Shivali	f
Shri	f
Shripati	m
Shyama	mf
Sita	f
Sri	f
Sumati	f
Sundara	m
Sunita	f
Suresha	m
Sushila	f
Tara	f
Uma	f
Usha	f
Ushas	f
Vasanta	m
Vasu	m
Vidya	f
Vijaya	mf
Vikrama	m
Vishnu	m
Yama	m
Yami	f
Surya	m
