Patrik	m
Kazimír	m
Magdaléna	f
Marika	f
Blanka	f
Dominik	m
Alida	f
Linda	f
Martin	m
Simon	m
Andrea	f
Alexander	m
Ada	f
Ida	f
Vince	m
Barbara	f
Anna	f
Liza	f
Rita	f
Felicia	f
Laura	f
Fanni	f
Jani	m
Kati	f
Tomi	m
Rudolf	m
Norbert	m
Paula	f
Rudi	m
Irma	f
Konstantin	m
Gabi	mf
Emil	m
Alexandra	f
Johanna	f
Katarina	f
Petra	f
Attila	m
Ábel	m
Ádám	m
Adél	f
Adorján	m
Adrienn	f
Ági	f
Ágnes	f
Ágoston	m
Ágota	f
Ákos	m
Alfréd	m
Aliz	f
Álmos	m
Ambrus	m
Anasztáz	m
Anasztázia	f
Andor	m
András	m
Angyalka	f
Anikó	f
Annuska	f
Antal	m
Aranka	f
Arisztid	m
Áron	m
Árpád	m
Artúr	m
Aurél	m
Aurélia	f
Balázs	m
Bálint	m
Bandi	m
Barna	m
Barnabás	m
Bartal	m
Béla	m
Bence	m
Benedek	m
Benjámin	m
Bernadett	f
Bernát	m
Bertalan	m
Bertók	m
Bianka	f
Boldizsár	m
Borbála	f
Bözsi	f
Cili	f
Csaba	m
Csenge	f
Csilla	f
Dani	m
Dániel	m
Demeter	m
Dénes	m
Dezso	m
Diána	f
Domonkos	m
Dömötör	m
Donát	m
Dóra	f
Dorika	f
Dorottya	f
Duci	f
Edina	f
Edit	f
Eduárd	m
Edvárd	m
Elek	m
Éliás	m
Emánuel	m
Emese	f
Endre	m
Eniko	f
Erno	m
Ervin	m
Erzsébet	f
Erzsi	f
Eszter	f
Eszti	f
Etel	f
Etelka	f
Éva	f
Évike	f
Fábián	m
Fabó	m
Felícia	f
Felicitás	f
Ferenc	m
Feri	m
Ferkó	m
Flóra	f
Franci	f
Franciska	f
Frigyes	m
Fruzsina	f
Fülöp	m
Gábor	m
Gábriel	m
Gáspár	m
Gazsi	m
Gellért	m
Gergely	m
Gergo	m
Gertrúd	f
Géza	m
Gizella	f
Gizi	f
Gréta	f
Gusztáv	m
Gyöngyi	f
György	m
Györgyi	f
Györgyike	f
Gyozo	m
Gyula	m
Gyuri	m
Hajna	f
Hajnal	f
Hajnalka	f
Ibolya	f
Ildi	f
Ildikó	f
Ildó	f
Ili	f
Ilka	f
Illés	m
Ilonka	f
Imre	m
Imrus	m
Irén	f
Irmuska	f
István	m
Izsák	m
Jakab	m
Jákob	m
Jancsi	m
Janika	m
János	m
Jenci	m
Jeno	m
Jola	f
Jolán	f
Jolánka	f
Jóska	m
József	m
Józsi	m
Józsua	m
Juli	f
Juliska	f
Kálmán	m
Kamilla	f
Karcsi	m
Karola	f
Károly	m
Kató	f
Kázmér	m
Kelemen	m
Kitti	f
Klotild	f
Kornél	m
Kornélia	f
Kristóf	m
Krisztián	m
Krisztina	f
Laci	m
Lajos	m
László	m
Lázár	m
Loránd	m
Lóránt	m
Lorinc	m
Luca	f
Lujza	f
Lukács	m
Magdolna	f
Mara	f
Margaréta	f
Mariska	f
Márk	m
Márta	f
Márton	m
Mártuska	f
Máté	m
Matild	f
Mátyás	m
Mihály	m
Miklós	m
Miksa	m
Miléna	f
Misi	m
Miska	m
Mónika	f
Móric	m
Mózes	m
Nándor	m
Nikolett	f
Ödi	m
Ödön	m
Orbán	m
Orsolya	f
Oszkár	m
Ottó	m
Pál	m
Panni	f
Péter	m
Peti	m
Piri	f
Piroska	f
Pista	m
Pisti	m
Ráhel	f
Rebeka	f
Richárd	m
Rikárd	m
Róbert	m
Robi	m
Román	m
Romána	f
Róza	f
Rozália	f
Rózsa	f
Rózsi	f
Salamon	m
Sámuel	m
Sándor	m
Sanyi	m
Sári	f
Sárika	f
Sebestyén	m
Stefánia	f
Szabina	f
Szabolcs	m
Szandra	f
Szilárd	m
Szilveszter	m
Szilvia	f
Tamás	m
Teca	f
Teodóra	f
Teréz	f
Tiborc	m
Tímea	f
Tivadar	m
Tódor	m
Tóni	m
Tünde	f
Tündér	f
Vencel	m
Vida	m
Vilmos	m
Virág	f
Zita	f
Zoltán	m
Zsanett	f
Zsazsa	f
Zsiga	m
Zsigmond	m
Zsófia	f
Zsófika	f
Zsóka	f
Zsolt	m
Zsuzsa	f
Zsuzsanna	f
Zsuzsi	f
Katalin	f
Marica	f
Ignác	m
Klára	f
Beáta	f
Konrád	m
Renáta	f
Sára	f
Tibor	m
Kata	f
Sami	m
Samu	m
Marcell	m
Ilona	f
Izabella	f
Julianna	f
Valéria	f
Amália	f
Natália	f
Margit	f
Dávid	m
Margita	f
Mária	f
Melánia	f
Terézia	f
Viktória	f
Jozefa	f
Vili	m
Judit	f
Marianna	f
Gabriella	f
Olimpia	f
Andris	m
Berta	f
Kinga	f
Karolina	f
Júlia	f
Antónia	f
Cecília	f
Olívia	f
Veronika	f
Olga	f
Filip	m
Erika	f
Edvin	m
Viktor	m
Henrik	m
Vilhelm	m
Teodor	m
Nikola	m
Marián	m
Vid	m
Adelaida	f
Vilma	f
Mari	f
