Adaeze	f
Adanna	f
Adannaya	f
Akachi	mf
Akuchi	mf
Amadi	m
Amaka	f
Amara	f
Amarachi	f
AÃ±uli	f
Azubuike	m
Chiamaka	f
Chibueze	mf
Chibuike	mf
Chibuzo	mf
Chichi	f
Chidi	mf
Chidiebere	mf
Chidiebube	mf
Chidiegwu	mf
Chidike	m
Chidimma	f
Chidubem	m
Chiemeka	m
Chijindum	mf
Chika	f
Chike	mf
Chikelu	mf
Chikere	mf
Chima	m
Chinasa	f
Chinedu	mf
Chinwe	mf
Chinweike	mf
Chinwendu	mf
Chinweuba	mf
Chinyelu	f
Chinyere	f
Chioma	mf
Chizoba	mf
Chuks	m
Chukwudi	m
Chukwuemeka	m
Chukwuma	m
Ebele	f
Ekene	mf
Ekenedilichukwu	mf
Ekwueme	m
Emeka	m
Enyinnaya	m
Fumnanya	f
Funanya	f
Ikenna	m
Ndidi	mf
Ngozi	mf
Nkechi	f
Nkechinyere	f
Nkemdilim	mf
Nkiru	f
Nkiruka	f
Nnamdi	m
Nneka	f
Nnenna	f
Nnenne	f
Nwanneka	f
Obi	m
Ogechi	f
Ogechukwukama	f
Oluchi	mf
Onyeka	f
Onyekachi	mf
Onyekachukwu	mf
Udo	mf
Uzochi	m
Uzoma	mf
Chi	mf
