Abha	f
Abhay	m
Abhilasha	f
Aishwarya	f
Ajeet	m
Ajit	m
Ajith	m
Akanksha	f
Akash	m
Akhil	m
Amala	f
Amar	m
Amit	m
Amita	f
Amrit	m
Amrita	f
Anand	m
Ananda	f
Anandi	f
Ananth	m
Anantha	mf
Anila	f
Anima	f
Anish	m
Anjali	f
Ankita	f
Ankur	m
Anuj	m
Anuja	f
Anupam	m
Aravind	m
Aravinda	m
Archana	f
Arjun	m
Arun	m
Arya	mf
Aseem	m
Asha	f
Ashok	m
Ashoka	m
Asim	m
Avani	f
Avanti	f
Avinash	m
Baldev	m
Bharat	m
Bhaskar	m
Chanda	mf
Chandan	m
Chandana	f
Chander	m
Chandrakant	m
Chandrakanta	f
Chetan	m
Chetana	f
Chiranjeevi	m
Chiranjivi	m
Damodar	m
Darshana	f
Dayaram	m
Deepak	m
Deepali	f
Deepti	f
Deo	m
Deodan	m
Dev	m
Devadas	m
Devdan	m
Devdas	m
Devika	f
Devraj	m
Dhananjay	m
Dhaval	m
Dilip	m
Dinesh	m
Dipak	m
Dipali	f
Dipika	f
Dipti	f
Divya	f
Duleep	m
Esha	f
Ganesh	m
Gautam	m
Gautama	m
Girish	m
Gita	f
Gopal	m
Gopinath	m
Gotam	m
Govind	m
Gowri	f
Harendra	m
Harish	m
Harsha	m
Harshad	m
Harshal	m
Ila	f
Indu	f
Isha	m
Jagannath	m
Jagdish	m
Jai	m
Jaidev	m
Jay	m
Jayant	m
Jayashri	f
Jayendra	m
Jaywant	m
Jeetendra	m
Jitendra	m
Jyoti	f
Jyotsana	f
Jyotsna	f
Kailash	m
Kajal	f
Kala	f
Kalidas	m
Kalidasa	m
Kalpana	f
Kalyan	m
Kamal	m
Kanchana	f
Kanta	f
Kapil	m
Karan	m
Karishma	f
Kashi	f
Kasi	f
Kausalya	f
Kaveri	f
Kavi	m
Kavita	f
Kiran	mf
Kishan	m
Kishen	m
Kishor	m
Kishore	m
Kishori	f
Kistna	m
Kshitij	m
Kshitija	f
Kumar	m
Kunal	m
Kunala	m
Lakshman	m
Lal	m
Lalit	m
Lata	f
Lavanya	f
Laxman	m
Laxmi	f
Leela	f
Lila	f
Lilavati	f
Lina (3)	f
Lochan	m
Lochana	f
Madhav	m
Madhu	mf
Madhukar	m
Madhur	mf
Madhuri	f
Mahavir	m
Mahavira	m
Mahendra	m
Mahesh	m
Mala	f
Malati	f
Manish	m
Manisha	f
Manju	f
Manjula	f
Manjusha	f
Mayur	m
Meena	f
Meera	f
Minali	f
Mira	f
Mitul	m
Mohan	m
Mohandas	m
Mukesh	m
Mukta	f
Mukul	m
Nagendra	m
Narayan	m
Narendra	m
Naveen	m
Navin	m
Neela	f
Neelam	mf
Neha	f
Nikhil	m
Nikhila	f
Nila	f
Nilam	mf
Ninad	m
Niraj	m
Nirav	m
Nisha	f
Nishant	m
Nithya	mf
Nitika	f
Nitin	m
Nitya	mf
Om	m
Padmini	f
Pallab	m
Pallav	m
Pankaj	m
Parth	m
Pitambar	m
Poornima	f
Prabhakar	m
Prabhakara	m
Prabhat	m
Prabodh	m
Pradeep	m
Pradip	m
Prakash	m
Pramod	m
Pran	m
Pranav	m
Pranay	m
Prasad	m
Prasanna	m
Pratap	m
Pratibha	f
Pratima	f
Pravin	m
Preeti	f
Prem	m
Prema	f
Priti	f
Punit	m
Purnima	f
Purushottam	m
Pushpa	f
Rachana	f
Rachna	f
Rahul	m
Raj	m
Raja	m
Rajender	m
Rajendra	m
Rajesh	m
Rajiv	m
Rajkumari	f
Rajneesh	m
Rajni	f
Rajnish	m
Rakesh	m
Ram	m
Ramachander	m
Ramakrishna	m
Ramesh	m
Rameshwar	m
Rani	f
Ranj	m
Ranjeet	m
Ranjit	m
Rashmi	f
Ratan	m
Ratna	mf
Ratnam	m
Ravindra	m
Reena	f
Reshmi	f
Rina (3)	f
Rishi	m
Ritika	f
Riya	f
Rohan	m
Rohit	m
Sandeep	m
Sandip	m
Sanjana	f
Sanjay	m
Sanjeet	m
Sanjeev	m
Sanjit	m
Sanjiv	m
Sankar	m
Saral	m
Sarala	f
Sarika	f
Sarita	f
Sashi	mf
Satish	m
Seema	f
Seeta	f
Seetha	f
Sekar	m
Shakuntala	f
Shankar	m
Shanti	f
Sharma	m
Sharmila	f
Shashi	mf
Sheela	f
Shekhar	m
Shila	f
Shobha	f
Shresth	m
Shreya	f
Shrinivas	m
Shrivatsa	m
Shweta	f
Shyam	m
Shyamal	m
Shyamala	f
Sib	m
Siddharta	m
Siddhartha	m
Sima	f
Sitara	f
Sonal	f
Subhash	m
Sudarshan	m
Sudarshana	f
Sudhir	m
Sujay	m
Sulabha	f
Suman	m
Sumantra	m
Sundar	m
Sunder	m
Sunil	m
Sunitha	f
Suniti	f
Suraj	m
Surendra	m
Suresh	m
Susheela	f
Sushil	m
Swapan	m
Swapna	mf
Swapnil	m
Swaran	m
Swarna	mf
Swati	f
Trishna	f
Vasant	m
Vasanti	f
Vasuda	f
Veda	f
Vena	f
Venkat	m
Venkata	m
Vijay	m
Vikram	m
Vimal	m
Vimala	f
Vina	f
Vinay	m
Vipin	m
Vipul	m
Vishal	m
Vivek	m
Yamuna	f
Yash	m
Aditi	f
Aditya	m
Agni	m
Ananta	mf
Anil	m
Aniruddha	m
Arjuna	m
Aruna	m
Arundhati	f
Bala	mf
Baladeva	m
Bharata	m
Bhaskara	m
Chandra	mf
Damayanti	f
Damodara	m
Devaraja	m
Devi	f
Dilipa	m
Dipaka	m
Draupadi	f
Drupada	m
Durga	f
Ganesha	m
Gauri	f
Girisha	m
Gopala	m
Gopinatha	m
Gotama	m
Govinda	m
Hari	m
Harisha	m
Indira	f
Indra	m
Indrajit	m
Indrani	f
Jagannatha	m
Jaya	f
Jayanti	f
Kali	f
Kalyani	f
Kama	m
Kamala	f
Kanti	f
Kapila	m
Karna	m
Krishna	m
Kumara	m
Kumari	f
Lakshmana	m
Lakshmi	f
Lalita	f
Madhava	m
Madhavi	f
Mahesha	m
Mani	m
Manu	m
Maya	f
Mina	f
Mohana	mf
Mohini	f
Mukesha	m
Murali	m
Nala	m
Nanda	m
Narayana	m
Padma	mf
Padmavati	f
Pankaja	m
Partha	m
Parvati	f
Pitambara	m
Prabhu	m
Pramoda	m
Pritha	f
Priya	f
Purushottama	m
Radha	f
Raghu	m
Rajani	f
Rama	m
Ramachandra	m
Ramesha	m
Rati	f
Ravi	m
Reva	f
Rukmini	f
Sachin	m
Sandhya	f
Sanjaya	m
Saraswati	f
Sati	f
Savitr	m
Savitri	f
Shailaja	f
Shakti	f
Shankara	m
Shanta	f
Shantanu	m
Shiva	m
Shivali	f
Shri	f
Shripati	m
Shyama	mf
Sita	f
Sri	f
Sumati	f
Sundara	m
Sunita	f
Suresha	m
Sushila	f
Tara	f
Uma	f
Usha	f
Ushas	f
Vasanta	m
Vasu	m
Vidya	f
Vijaya	mf
Vikrama	m
Vishnu	m
Yama	m
Yami	f
Surya	m
Roshan	mf
