Surya	m
Bambang	m
Bethari	f
Bima	m
Cahya	m
Citra	f
Darma	m
Dian	m
Dwi	mf
Eka	mf
Eko	mf
Guntur	m
Harta	m
Indah	f
Intan	f
Krisna	m
Kusuma	m
Kuwat	m
Lestari	f
Mega	f
Nirmala	f
Purnoma	m
Raharjo	m
Ratu	f
Setiawan	m
Sinta	f
Slamet	m
Suharto	m
Sukarno	m
Susila	m
Tirta	m
Tri	mf
Utari	f
Wangi	f
Wibawa	m
Wira	m
Wulan	f
Yuda	m
