Áed	m
Áedán	m
Eógan	m
Fedelmid	mf
Fedlimid	mf
Feidlimid	mf
Óengus	m
Deirdre	f
Oscar	m
Bile	m
Cáel	m
Céibhfhionn	f
Clídna	f
Conlaoch	m
Connla	m
Cúchulainn	m
Dagda	m
Derdriu	f
Éber	m
Étaín	f
Fedelm	f
Feidelm	f
Finn	m
Goibniu	m
Lir	m
Lug	m
Lugaid	m
Lugh	m
Medb	f
Morrigan	f
Mórríghan	f
Muirne	f
Nuada	m
Nuadha	m
Parthalan	m
Ríghnach	f
Ríoghnach	f
Sabia	f
Lóegaire	m
Connor	m
Ailill	m
Aoife	f
Bébinn	f
Bláthnat	f
Cian	m
Clíodhna	f
Conchobhar	m
Dáire	m
Diarmaid	m
Éibhear	m
Eimear	f
Emer	f
Fachtna	m
Fiachra	m
Finnguala	f
Finnuala	f
Fintan	m
Fionn	m
Fionnghuala	f
Fionnuala	f
Gráinne	f
Lughaidh	m
Maeve	f
Méabh	f
Meadhbh	f
Muirenn	f
Muirgen	f
Neasa	f
Niamh	f
Oisín	m
Sadb	f
Sadbh	f
Aodh	m
Aodhán	m
Aonghus	m
Conall	m
Eoghan	m
Fearghas	m
Fergus	m
Naoise	m
