Faustina	f
Aurelia	f
Milena	f
Amalia	f
Linda	f
Emma	f
Alice	f
Claudia	f
Lisa	f
Elmo	m
Flora	f
Ida	f
Lora	f
Loretta	f
Luana	f
Mina	f
Norma	f
Rina	f
Serena	f
Berenice	f
Barbara	f
Sabrina	f
Cornelia	f
Angela	f
Anna	f
Alberta	f
Regina	f
Clarissa	f
Monica	f
Veronica	f
Angelica	f
Lina	f
Viola	f
Camilla	f
Tina	f
Roberta	f
Olivia	f
Delia	f
Gloria	f
Virginia	f
Sonia	f
Irene	f
Cecilia	f
Evelina	f
Rebecca	f
Rita	f
Celia	f
Amelia	f
Diana	f
Laura	f
Amanda	f
Nadia	f
Achille	m
Isa	f
Adele	f
Irma	f
Augusta	f
Alina	f
Anselma	f
Elisa	f
Daniela	f
Martina	f
Clio	f
Gaia	f
Sara	f
Abele	m
Adamo	m
Agostina	f
Agostino	m
Alessa	f
Alessandra	f
Alessandro	m
Alessia	f
Alessio	m
Alfeo	m
Alfonsina	f
Alonzo	m
Alvise	m
Amadeo	m
Amato	m
Ambra	f
Ambrogino	m
Ambrogio	m
Amedea	f
Amedeo	m
Amerigo	m
Amilcare	m
Ampelio	m
Anastasio	m
Andrea	m
Andreina	f
Angelo	m
Annalisa	f
Annetta	f
Annibale	m
Annunciata	f
Annunziata	f
Antonella	f
Antonello	m
Antonino	m
Arcangelo	m
Arduino	m
Arianna	f
Arnaldo	m
Aroldo	m
Arrigo	m
Assunta	f
Attilio	m
Azzurra	f
Baldassare	m
Baldo	m
Baldovino	m
Bartolomeo	m
Battista	m
Benedetta	f
Benedetto	m
Beniamino	m
Benvenuto	m
Beppe	m
Bernardetta	f
Bertoldo	m
Bertrando	m
Bettina	f
Bettino	m
Biaggio	m
Biagino	m
Biagio	m
Bice	f
Bonaventura	m
Callisto	m
Calogera	f
Calogero	m
Camillo	m
Carlo	m
Carlotta	f
Carmine	m
Cesare	m
Cesarina	f
Cesarino	m
Chiara	f
Chiarina	f
Cinzia	f
Cirillo	m
Claretta	f
Clelia	f
Colomba	f
Colombano	m
Colombina	f
Colombo	m
Concetta	f
Concettina	f
Concetto	m
Consolata	f
Corrado	m
Cosima	f
Cosimo	m
Cosma	m
Costantino	m
Costanzo	m
Crescenzo	m
Cristoforo	m
Crocetta	f
Crocifissa	f
Dafne	f
Damiana	f
Damiano	m
Daniele	m
Dante	m
Dario	m
Davide	m
Dino	m
Domenica	f
Domenico	m
Donata	f
Donatella	f
Donatello	m
Doriano	m
Duilio	m
Durante	m
Edda	f
Edmonda	f
Edmondo	m
Edoardo	m
Edvige	f
Efisio	m
Egidio	m
Elda	f
Elettra	f
Elio	m
Elisabetta	f
Eloisa	f
Emanuele	m
Emidio	m
Ennio	m
Enrica	f
Enrico	m
Erasmo	m
Ercole	m
Ermanno	m
Ermelinda	f
Ermenegildo	m
Ermete	m
Erminia	f
Erminio	m
Ersilia	f
Ettore	m
Eustachio	m
Eustorgio	m
Ezio	m
Fabrizia	f
Fabrizio	m
Fedele	m
Federica	f
Federigo	m
Felice	m
Felìcita	f
Ferdinando	m
Ferruccio	m
Fiammetta	f
Filiberto	m
Filippo	m
Fina	f
Fioralba	f
Fiorella	f
Fiorenza	f
Fiorenzo	m
Firmino	m
Floriano	m
Franca	f
Francesca	f
Francesco	m
Franco	m
Frediano	m
Fulgenzio	m
Fulvio	m
Gabriele	m
Gaetana	f
Gaetano	m
Gaspare	m
Gasparo	m
Gavino	m
Geltrude	f
Gennaro	m
Genoveffa	f
Gerolamo	m
Geronimo	m
Gia	f
Giachetta	f
Giacinta	f
Giacinto	m
Giacobbe	m
Giacomo	m
Giada	f
Giambattista	m
Giampaolo	m
Giampiero	m
Giancarlo	m
Gianfranco	m
Gianluca	m
Gianluigi	m
Gianmarco	m
Gianmaria	m
Gianna	f
Gianni	m
Giannina	f
Giannino	m
Gianpaolo	m
Gianpiero	m
Ginevra	f
Gino	m
Gioacchino	m
Gioachino	m
Gioconda	f
Gioia	f
Giordano	m
Giorgia	f
Giorgina	f
Giorgino	m
Giorgio	m
Giosetta	f
Giosuè	m
Giotto	m
Giovanna	f
Giovannetta	f
Giovanni	m
Giraldo	m
Girolamo	m
Gisella	f
Giuditta	f
Giulia	f
Giuliana	f
Giuliano	m
Giulietta	f
Giulio	m
Giuseppa	f
Giuseppe	m
Giuseppina	f
Giustina	f
Giustino	m
Goffredo	m
Grazia	f
Graziana	f
Graziano	m
Graziella	f
Gualtiero	m
Guerino	m
Guglielmo	m
Ignazio	m
Ilaria	f
Ilario	m
Ilda	f
Immacolata	f
Ines	f
Innocenzo	m
Ippolito	m
Isaia	m
Isotta	f
Itala	f
Italia	f
Italo	m
Jacopo	m
Ladislao	m
Lauretta	f
Lauro	m
Lazzaro	m
Lelia	f
Leone	m
Leonora	f
Leonzio	m
Letizia	f
Lia	f
Liberatore	m
Liboria	f
Liborio	m
Livio	m
Lodovico	m
Loreta	f
Loreto	mf
Loris	m
Lorita	f
Lothario	m
Lucrezia	f
Ludovica	f
Ludovico	m
Luigi	m
Luigia	f
Luigina	f
Luigino	m
Luisella	f
Maddalena	f
Manfredo	m
Manlio	m
Marcellino	m
Marcello	m
Margherita	f
Mariangela	f
Mariella	f
Marietta	f
Marilena	f
Marinella	f
Marino	m
Martino	m
Marzia	f
Marzio	m
Massimiliano	m
Massimo	m
Matteo	m
Mattia	m
Maurizio	m
Melchiorre	m
Michela	f
Michelangela	f
Michelangelo	m
Michele	m
Michelina	f
Mimi	f
Mirabella	f
Mirella	f
Naldo	m
Natale	m
Natanaele	m
Nazzareno	m
Nerina	f
Nerio	m
Nero	m
Nestore	m
Nevio	m
Niccolò	m
Nicola	m
Nicoletta	f
Nicolina	f
Nicolò	m
Nicomedo	m
Nicostrato	m
Nino	m
Norina	f
Nunzia	f
Nunziatina	f
Nunzio	m
Oliviero	m
Orazio	m
Oria	f
Oriana	f
Orlanda	f
Orlando	m
Ornella	f
Orsina	f
Orsino	m
Orso	m
Orsola	f
Ottavia	f
Ottaviano	m
Ottavio	m
Palmiro	m
Pancrazio	m
Panfilo	m
Pantaleone	m
Paolina	f
Paolino	m
Paolo	m
Paride	m
Pasquale	m
Pasqualina	f
Pasqualino	m
Patrizia	f
Patrizio	m
Pellegrino	m
Peppe	m
Peppi	m
Piera	f
Pierina	f
Piero	m
Pietra	f
Pietrina	f
Pietro	m
Pina	f
Pino	m
Placido	m
Pompeo	m
Ponzio	m
Prudenzio	m
Quirino	m
Rachele	f
Raffaele	m
Raffaella	f
Raffaello	m
Raimonda	f
Raimondo	m
Raniero	m
Remo	m
Renzo	m
Riccarda	f
Riccardo	m
Rico	m
Rinaldo	m
Rino	m
Rocco	m
Romano	m
Romeo	m
Romilda	f
Romola	f
Romolo	m
Rosabella	f
Rosalba	f
Rosangela	f
Rosaria	f
Rosella	f
Rosetta	f
Rosina	f
Rossana	f
Rossella	f
Ruggero	m
Ruggiero	m
Sabino	m
Salvatore	m
Salvatrice	f
Samanta	f
Samuela	f
Samuele	m
Sandro	m
Sansone	m
Santa	f
Santino	m
Santo	m
Santuzza	f
Saveria	f
Saverio	m
Savina	f
Savino	m
Savio	m
Scevola	m
Scilla	f
Sebastiana	f
Sebastiano	m
Selvaggia	f
Serafino	m
Sesto	m
Settimio	m
Sibilla	f
Silvana	f
Silvano	m
Silvestro	m
Simone	m
Simonetta	f
Stefano	m
Sveva	f
Taddeo	m
Tammaro	m
Tancredi	m
Teofilo	m
Terenzio	m
Terzo	m
Tino	m
Tiziana	f
Tiziano	m
Tommaso	m
Tonio	m
Tore	m
Tullio	m
Uberto	m
Ugo	m
Ulderico	m
Ulisse	m
Umberto	m
Urbana	f
Valentino	m
Vanda	f
Vanna	f
Vanni	m
Velia	f
Venceslao	m
Vespasiano	m
Vico	m
Vilfredo	m
Vincente	m
Vincenza	f
Vincenzo	m
Vitale	m
Vitalia	f
Vittore	m
Vittoria	f
Vittorino	m
Vittorio	m
Domitilla	f
Fabia	f
Fausta	f
Floriana	f
Fulvia	f
Liviana	f
Lucilla	f
Tullia	f
Caterina	f
Noemi	f
Simona	f
Elia	m
Nico	m
Beatrice	f
Celeste	mf
Rosanna	f
Gemma	f
Annabella	f
Marianna	f
Sandra	f
Angelina	f
Gina	f
Enzo	m
Luce	f
Carola	f
Ferdinanda	f
Guido	m
Marcella	f
Zita	f
Debora	f
Eleonora	f
Lucia	f
Albertina	f
Clara	f
Gabriella	f
Leontina	f
Petronilla	f
Rosalia	f
Agnese	f
Serafina	f
Teofila	f
Stefania	f
Daria	f
Antonina	f
Albina	f
Romana	f
Adriano	m
Cristiana	f
Cristiano	m
Fabiano	m
Germano	m
Gilda	f
Mafalda	f
Mauro	m
Pio	m
Raul	m
Alda	f
Aldo	m
Lia	f
Maria	mf
Severina	f
Liana	f
Catarina	f
Iolanda	f
Carla	f
Adelina	f
Danilo	m
Bianca	f
Loredana	f
Luca	m
Livia	f
Violetta	f
Valentina	f
Pia	f
Silvestra	f
Adolfo	m
Alba	f
Armida	f
Arturo	m
Basilio	m
Carmela	f
Carmina	f
Ciriaco	m
Cirino	m
Ciro	m
Claudio	m
Clemente	m
Delfina	f
Demetrio	m
Desiderio	m
Eliana	f
Eligio	m
Eliseo	m
Ernesta	f
Eugenio	m
Fabio	m
Flavio	m
Gerardo	m
Gregorio	m
Imelda	f
Lorenza	f
Lorenzo	m
Lucio	m
Mario	m
Nazario	m
Orfeo	m
Ovidio	m
Paola	f
Perla	f
Perlita	f
Plinio	m
Porfirio	m
Prospero	m
Robertina	f
Severiano	m
Severo	m
Tecla	f
Teo	m
Teodosio	m
Tito	m
Urbano	m
Vinicio	m
Virgilio	m
Vito	m
Elena	f
Antonia	f
Fabiola	f
Isabella	f
Bibiana	f
Desideria	f
Maura	f
Viviana	f
Melania	f
Adalberto	m
Alberto	m
Alfredo	m
Anacleto	m
Anselmo	m
Aurelio	m
Benigno	m
Bernardino	m
Bernardo	m
Bonifacio	m
Celio	m
Celso	m
Cipriano	m
Clementina	f
Cleto	m
Donato	m
Elpidio	m
Emiliana	f
Emilio	m
Ernesto	m
Eufemia	f
Fausto	m
Feliciano	m
Fortunato	m
Gervasio	m
Gilberto	m
Glauco	m
Gustavo	m
Leopoldo	m
Luciano	m
Marco	m
Mariano	m
Micaela	f
Narciso	m
Nicodemo	m
Primo	m
Remigio	m
Renato	m
Roberto	m
Rodolfo	m
Rufino	m
Sergio	m
Severino	m
Silvio	m
Tacito	m
Teodoro	m
Timoteo	m
Valerio	m
Fabiana	f
Luciana	f
Filomena	f
Carolina	f
Marisa	f
Eva	f
Aurora	f
Lino	m
Renata	f
Marina	f
Leonardo	m
Fortunata	f
Cristina	f
Adriana	f
Sabina	f
Liliana	f
Silvia	f
Teodora	f
Flavia	f
Emilia	f
Valeria	f
Eugenia	f
Olimpia	f
Dorotea	f
Agata	f
Susanna	f
Placida	f
Sofia	f
Berta	f
Alfreda	f
Lidia	f
Natalia	f
Amando	m
Nina	f
Tatiana	f
Agapito	m
Alfonso	m
Antonietta	f
Antonio	m
Benito	m
Carmelo	m
Celestina	f
Cornelio	m
Dionisio	m
Emiliano	m
Eusebio	m
Federico	m
Isidoro	m
Luisa	f
Ofelia	f
Rosalinda	f
Rosario	mf
Eulalia	f
Feliciana	f
Armando	m
Augusto	m
Celestino	m
Evaristo	m
Faustino	m
Modesto	m
Osvaldo	m
Palmira	f
Rolando	m
Saturnino	m
Susana	f
Marta	f
Benigna	f
Rosa	f
Arsenio	m
Casimiro	m
Cecilio	m
Leandro	m
Lorena	f
Teobaldo	m
Vasco	m
Teresa	f
Rodrigo	m
Rut	f
