Ai	f
Aiko	f
Aimi	f
Aina (3)	f
Airi	f
Akane	f
Akemi	f
Aki	f
Akiko	f
Akio	m
Akira	mf
Ami (3)	f
Aoi	mf
Arata	m
Asuka	f
Atsuko	f
Aya	f
Ayaka	f
Ayako	f
Ayame	f
Ayane	f
Ayano	f
Ayumu	m
Chika	f
Chikako	f
Chinatsu	f
Chiyo	f
Chiyoko	f
Cho	f
Chou	f
Chouko	f
Daichi	m
Daiki	m
Daisuke	m
Emi	f
Etsuko	f
Goro	m
Gorou	m
Hachiro	m
Hachirou	m
Hana (3)	f
Hanako	f
Haru	m
Haruka	f
Haruki	m
Haruko	f
Haruna	f
Haruto	m
Hayate	m
Hayato	m
Hibiki	m
Hideaki	m
Hideki	m
Hideyoshi	m
Hikari	f
Hikaru	mf
Hina	f
Hinata	mf
Hiraku	m
Hiroko	f
Hiroshi	m
Hiroto	m
Hitomi	f
Honoka	f
Hoshi	f
Hoshiko	f
Hotaka	m
Hotaru	f
Ichiro	m
Ichirou	m
Isamu	m
Itsuki	m
Izumi	f
Jiro	m
Jirou	m
Junko	f
Juro	m
Jurou	m
Kaede	mf
Kaito	m
Kanon	f
Kaori	f
Kaoru	mf
Kasumi	f
Katashi	m
Katsu	m
Katsuo	m
Katsuro	m
Katsurou	m
Kazuki	m
Kazuko	f
Kazuo	m
Keiko	f
Ken	m
Ken'ichi	m
Kenji	m
Kenshin	m
Kenta	m
Kichiro	m
Kichirou	m
Kiku	f
Kimiko	f
Kiyoko	f
Kiyoshi	m
Kohaku	mf
Kokoro	f
Kotone	f
Kouki	m
Kouta	m
Kumiko	f
Kuro	m
Kurou	m
Kyo	mf
Kyou	mf
Mai	f
Makoto	mf
Mami	f
Manami	f
Mao	f
Mariko	f
Masami	f
Masaru	m
Masuyo	f
Mayu	f
Megumi	f
Mei	f
Michi	mf
Michiko	f
Midori	f
Miki	f
Miku	f
Minako	f
Minoru	m
Mio	f
Misaki	f
Mitsuko	f
Miu	f
Miyako	f
Miyu	f
Mizuki	f
Moe	f
Momoka	f
Momoko	f
Moriko	f
Nana	f
Nanami	f
Naoki	m
Naoko	f
Naomi	f
Natsuki	f
Natsuko	f
Natsumi	f
Noa	f
Noboru	m
Nobu	m
Noburu	m
Nobuyuki	m
Nori	m
Noriko	f
Osamu	m
Ran	f
Rei	f
Ren	mf
Riko	f
Riku	m
Rikuto	m
Rin	f
Rina (4)	f
Rio	f
Rokuro	m
Rokurou	m
Ryo	m
Ryoichi	m
Ryota	m
Ryou	m
Ryouichi	m
Ryouta	m
Ryuu	m
Ryuunosuke	m
Saburo	m
Saburou	m
Sachiko	f
Saki	f
Sakura	f
Sakurako	f
Satomi	f
Sayuri	f
Setsuko	f
Shichiro	m
Shichirou	m
Shin	m
Shinju	f
Shinobu	mf
Shiori	f
Shiro	m
Shirou	m
Shizuka	f
Sho	m
Shou	m
Shouta	m
Shun	f
Sora	mf
Souta	m
Sumiko	f
Susumu	m
Suzu	f
Suzume	f
Taichi	m
Taiki	m
Takahiro	m
Takako	f
Takara	f
Takashi	m
Takehiko	m
Takeshi	m
Takuma	m
Takumi	m
Tamiko	f
Taro	m
Tarou	m
Tomiko	f
Tomoko	f
Tomomi	f
Tsubaki	f
Tsubame	f
Tsubasa	m
Tsukiko	f
Ume	f
Umeko	f
Wakana	f
Yamato	m
Yasu	mf
Yoko	f
Yori	m
Yoshi	mf
Yoshiko	f
Yoshiro	m
Yoshirou	m
Youko	f
Youta	m
Yua	f
Yui	f
Yuina	f
Yuki	f
Yukiko	f
Yuko	f
Yumi	f
Yumiko	f
Yuri	f
Yuu	mf
Yuudai	m
Yuuka	f
Yuuki	mf
Yuuko	f
Yuuma	m
Yuuna	f
Yuuta	m
Yuuto	m
Yuzuki	f
