Aida	f
Angelica	f
Aladdin	m
Amaryllis	f
Aminta	m
Aragorn	m
Aramis	m
Armide	f
Arwen	f
Astaroth	m
Astrophel	m
Atticus	m
Ayla (3)	f
Bayard	m
Belphoebe	f
Bilbo	m
Caspian	m
Cinderella	f
Cressida	f
Cymbeline	m
Cyrano	m
D'artagnan	m
Desdemona	f
Dulcinea	f
Elanor	f
Elrond	m
Eowyn	f
Eponine	f
Fantine	f
Faust	m
Figaro	m
Frodo	m
Galadriel	f
Gyneth	f
Haidee	f
Hamlet	m
Idril	f
Lalage	f
Lalla	f
Launce	m
Legolas	m
Lestat	m
Lucasta	f
Malvolio	m
Merry	m
Mignon	f
Nemo	m
Nerissa	f
Oberon	m
Olivette	f
Orinthia	f
Ossian	m
Othello	m
Perdita	f
Pharamond	m
Philomel	f
Pippin	m
Pollyanna	f
Rohan	f
Sam	m
Scheherazade	f
Sheherazade	f
Sherlock	m
Tinuviel	f
Titania	f
Tuor	m
Turin	m
Tybalt	m
Undine	f
Vivien	f
Yorick	m
Zuleika	f
Sophronia	f
Gandalf	m
