Bisera	f
Dimitar	m
Grozda	f
Grozdan	m
Grozdana	f
Iskra	f
Kiril	m
Nevena	f
Vasil	m
Zhivka	f
Zhivko	m
Aleksandar	m
Ekaterina	f
Mira	f
Goran	m
Ognjan	m
Vlatko	m
Darko	m
Zoran	m
Marija	f
Zora	f
Miroslav	m
Risto	m
Elena	f
Gjorgji	m
Gorgi	m
Liljana	f
Katerina	f
Ilija	m
Stojan	m
Snezhana	f
Irina	f
Vladimir	m
Filip	m
Petar	m
Dragana	f
Nikola	m
Dragan	m
Biljana	f
Jovan	m
Slobodan	m
Bojan	m
Bojana	f
Ana	f
