Anahera	f
Anaru	m
Aroha	f
Ataahua	f
Hemi	m
Hine	f
Hohepa	m
Huhana	f
Kiri	f
Maata	f
Mere	f
Mikaere	m
Moana	mf
Ngaio	f
Ngaire	f
Paora	m
Patariki	m
Petera	m
Piripi	m
Roimata	f
Ruiha	f
Tama	m
Tamati	m
Timoti	m
Tipene	m
Whetu	f
Wiremu	m
Tane	m
