Winona	f
Hiawatha	m
Pocahontas	f
Ahtahkakoop	m
Ailen	f
Antiman	m
Antinanco	m
Aputsiaq	m
Aqissiaq	m
Aucaman	m
Ayelen	f
Aylen	f
Calfuray	f
Catahecassa	m
Citlali	mf
Cowessess	m
Cuauht√©moc	m
Goyathlay	m
Hokolesqua	m
Isi	mf
Itzel	f
Kaneonuskatew	m
Kawacatoose	m
Kisecawchuck	m
Lalawethika	m
Maiara	f
Maquinna	m
Methoataske	f
Millaray	f
Moema	f
Muscowequan	m
Nahuel	m
Naira	f
Nanook	m
Nanuk	m
Nanuq	m
Nayeli	f
Nina (3)	f
Nita	f
Niviarsiaq	f
Nizhoni	f
Nuka	mf
Piloqutinnguaq	f
Pipaluk	f
Qillaq	m
Quanah	m
Quidel	m
Sacagawea	f
Sacnite	f
Saqui	f
Sayen	f
Shikoba	mf
Sissinnguaq	f
Tamaya	f
Tecumseh	m
Tenskwatawa	m
Tiriaq	m
Tupaarnaq	f
Ujarak	m
Ukaleq	f
Ulloriaq	f
Wapasha	m
Wayna	m
Wayra	m
Wickaninnish	m
Zyanya	f
Rayen	f
Xochitl	f
