Ashtoret	f
Ashtoreth	f
Bahman	m
Khurshid	mf
Shahrivar	mf
Adad	m
Ahriman	m
Ahura Mazda	m
Ameretat	f
Amordad	f
Amurdad	f
An	m
Anahita	f
Anat	f
Anatu	f
Angra Mainyu	m
Anu	m
Asherah	f
Ashtad	f
Ba'al	m
Baal	m
Cybele	f
Dagan	m
Dagon	m
Ea	m
El	m
Ellil	m
Enki	m
Enlil	m
Ereshkigal	f
Farvardin	mf
Gilgamesh	m
Govad	m
Hadad	m
Haurvatat	f
Hormazd	m
Inanna	f
Ishtar	f
Khordad	f
Lilith	f
Marduk	m
Melqart	m
Mithra	m
Mordad	f
Mot	m
Nanaea	f
Nina	f
Ormazd	m
Sarosh	m
Tanit	f
Tanith	f
Tiamat	f
Yam	m
