Gunnarr	m
Signý	f
Sigurðr	m
Svanhildr	f
Sigrún	f
Alfr	m
Alvis	m
Balder	m
Baldr	m
Eir	f
Frea	f
Frey	m
Freya	f
Freyja	f
Freyr	m
Frigg	f
Gerd	f
Grid	f
Heidrun	f
Hel	f
Idun	f
Loki	m
Njord	m
Oden	m
Odin	m
Saga	f
Sif	f
Skaði	f
Skuld	f
Thor	m
Þórr	m
Tyr	m
Urd	f
Verdandi	f
Völund	m
Yngvi	m
Grímhildr	f
Iðunn	f
Sindri	m
Gudrun	f
Gandalf	m
Svanhild	f
Alf	m
Borghild	f
Gunnar	m
Sigurd	m
Siv	f
Vidar	m
Jarl	m
