Marius	m
Åge	m
Aksel	m
Benedikte	f
Christen	m
Esben	m
Frode	m
Gregers	m
Grethe	f
Haldor	m
Halldor	m
Hjørdis	f
Janne	f
Jørg	m
Jørgen	m
Kristen	m
Lovise	f
Maiken	f
Malene	f
Margrethe	f
Mette	f
Morten	m
Ole	m
Peder	m
Pernille	f
Søren	m
Stine	f
Torbjørn	m
Vibeke	f
Kirsten	f
Else	f
Hanne	f
Karen	f
Johanne	f
Henriette	f
Mathilde	f
Agathe	f
Grete	f
Henning	m
Karoline	f
Lene	f
Steffen	m
Rebekka	f
Dorothea	f
Magdalena	f
Ågot	f
Alv	m
Andor	m
Annbjørg	f
Anniken	f
Arnbjørg	f
Asgeir	m
Aslaug	f
Audhild	f
Bergliot	f
Bergljot	f
Bjarte	m
Bjørg	f
Dagrun	f
Eirik	m
Erle	f
Frøya	f
Geir	m
Gjurd	m
Godtfred	m
Gøran	m
Gro	f
Gunnhild	f
Gunnvor	f
Haakon	m
Håkon	m
Halle	m
Hallvard	m
Halstein	m
Halvard	m
Halvdan	m
Håvard	m
Herleif	m
Ingvild	f
Jorun	f
Jorunn	f
Kaia	f
Kåre	m
Kari	f
Kjellfrid	f
Kjersti	f
Kjetil	m
Knute	m
Leiv	m
Magnhild	f
Marte	f
Njål	m
Odd	m
Oddmund	m
Ørjan	m
Øystein	m
Øyvind	m
Roald	m
Roar	m
Simen	m
Sindre	m
Sjurd	m
Snorre	m
Solveig	f
Stein	m
Sunniva	f
Svein	m
Sverre	m
Synnøve	f
Tallak	m
Terje	m
Thorbjørn	m
Thorstein	m
Tollak	m
Tone	f
Torbjørg	f
Torgeir	m
Torger	m
Torgils	m
Torhild	f
Toril	f
Tormod	m
Torny	f
Torø	f
Torstein	m
Varg	m
Veslemøy	f
Yngvar	m
Asbjørn	m
Åsmund	m
Bjørn	m
Dagfinn	m
Erlend	m
Espen	m
Gry	f
Gudbrand	m
Gulbrand	m
Halvor	m
Hege	f
Ingebjørg	f
Olav	m
Silje	f
Tine	f
Cecilie	f
Jacobine	f
Olaf	m
Svanhild	f
Alfhild	f
Hedda	f
Ola	m
Truls	m
Sofia	f
Marta	f
Alva	f
Kjell	m
Kjerstin	f
Marit	f
Marita	f
Mats	m
Matteus	m
Milly	f
Nils	m
Pål	m
Petter	m
Tuva	f
Tomas	m
