Sarra	f
Lydia	f
Anna	f
Martha	f
Maria	mf
Eva	f
Susanna	f
Adamu	m
Avraamu	m
Bartholomei	m
Daniilu	m
Davidu	m
Elisabeti	f
Esthiru	f
Filippu	m
Gavriilu	m
Iakovu	m
Ioannu	m
Iosifu	m
Magdalina	f
Matthei	m
Matthia	m
Mikhailu	m
Moysei	m
Onisimu	m
Pavelu	m
Ruthi	f
Samuilu	m
Simonu	m
Stefanu	m
Symeonu	m
Thoma	m
Timothei	m
Titu	m
Zaxaria	m
Petru	m
Andrei	m
Ilia	m
Varnava	m
