Adalbert	m
Pelagia	f
Zenon	m
Aurelia	f
Jagoda	f
Matylda	f
Mirek	m
Radek	m
Zoja	f
Milena	f
Kamil	m
Kamila	f
Blanka	f
Dominik	m
Dominika	f
Urban	m
Jan	m
Kasandra	f
Adam	m
Roland	m
Albert	m
Bernard	m
Robert	m
Alfred	m
Samuel	m
Hubert	m
Herbert	m
Edmund	m
Ada	f
Leon	m
Julia	f
Walter	m
Daniel	m
Barbara	f
Anna	f
Alberta	f
Regina	f
Adrianna	f
Damian	m
Edward	m
Marlena	f
Wanda	f
Leonard	m
Joanna	f
Julian	m
Adrian	m
Laura	f
Adela	f
Joachim	m
Gabriel	m
Roch	m
Donat	m
Marcel	m
Salomon	m
Klemens	m
Rupert	m
Leopold	m
Manfred	m
Alfons	m
Fabian	m
Magda	f
Rudolf	m
Helena	f
Magdalena	f
Norbert	m
Paula	f
Sebastian	m
Augusta	f
Alina	f
Angelika	f
Wilhelm	m
Daniela	f
Florian	m
August	m
Artur	m
Emil	m
Monika	f
Stefan	m
Waldemar	m
Konrad	m
Maja	f
Maja	f
Sara	f
Ilona	f
Izabella	f
Julianna	f
Marianna	f
Angelina	f
Eleonora	f
Serafina	f
Teofila	f
Stefania	f
Daria	f
Antonina	f
Albina	f
Romana	f
Maria	mf
Pia	f
Antonia	f
Melania	f
Renata	f
Adriana	f
Sabina	f
Liliana	f
Teodora	f
Emilia	f
Eugenia	f
Olimpia	f
Agata	f
Honorata	f
Olaf	m
Adelajda	f
Agnieszka	f
Aleksy	m
Alicja	f
Alojzy	m
Anastazja	f
Anastazy	m
Andrzej	m
Andzelika	f
Aniela	f
Anielka	f
Apolinary	m
Apolonia	f
Arkadiusz	m
Asia	f
Augustyn	m
Augustyna	f
Aureliusz	m
Bartlomiej	m
Bartosz	m
Basia	f
Bazyli	m
Beatrycze	f
Benedykt	m
Benedykta	f
Blazej	m
Bogna	f
Bogumil	m
Bogumila	f
Boguslaw	m
Boguslawa	f
Bolek	m
Boleslaw	m
Boleslawa	f
Bonifacy	m
Bozena	f
Bozydar	m
Cecylia	f
Celestyn	m
Celestyna	f
Celina	f
Cibor	m
Cyryl	m
Czcibor	m
Czeslaw	m
Czeslawa	f
Danuta	f
Dariusz	m
Dobrogost	m
Dobromil	m
Dobroslaw	m
Dobroslawa	f
Dosia	f
Edyta	f
Eliasz	m
Eligiusz	m
Elzbieta	f
Eugeniusz	m
Ewa	f
Felicja	f
Felicjan	m
Felicyta	f
Ferdynand	m
Filipina	f
Franciszek	m
Franciszka	f
Fryderyk	m
Fryderyka	f
Gawel	m
Genowefa	f
Gertruda	f
Gerwazy	m
Gracja	f
Grazyna	f
Grzegorz	m
Gustaw	m
Halina	f
Hania	f
Henryk	m
Henryka	f
Hipolit	m
Iga	f
Ignacja	f
Ignacy	m
Ireneusz	m
Iwo	m
Iwona	f
Izaak	m
Izolda	f
Izydor	m
Jacek	m
Jacenty	m
Jadwiga	f
Jadzia	f
Jagienka	f
Jagna	f
Jagusia	f
Janek	m
Janusz	m
Jarogniew	m
Jaromir	m
Jaropelk	m
Jaroslaw	m
Jaroslawa	f
Jedrzej	m
Jerzy	m
Joasia	f
Jolanta	f
Jowita	f
Jozafat	m
Józef	m
Józefa	f
Judyta	f
Julek	m
Julita	f
Juliusz	m
Jurek	m
Justyn	m
Justyna	f
Kacper	m
Kaja	f
Kajetan	m
Kasia	f
Katarzyna	f
Kazia	f
Kazimiera	f
Kazimierz	m
Klaudiusz	m
Klementyna	f
Konstancja	f
Konstanty	m
Konstantyn	m
Kornelia	f
Krysia	f
Krystian	m
Krystiana	f
Krystyn	m
Krystyna	f
Krzys	m
Krzysztof	m
Ksawery	m
Ksenia	f
Kuba	m
Kunegunda	f
Lech	m
Lechoslaw	m
Lechoslawa	f
Leokadia	f
Leslaw	m
Leslawa	f
Leszek	m
Lew	m
Longin	m
Longina	f
Lubomierz	m
Lubomir	m
Lucja	f
Lucja	f
Lucjan	m
Lucjusz	m
Lucyna	f
Ludmila	f
Ludwik	m
Ludwika	f
Lukasz	m
Maciej	m
Maksym	m
Maksymilian	m
Malgorzata	f
Malina	f
Malwina	f
Marceli	m
Marcelina	f
Marcin	m
Mariusz	m
Martyna	f
Maryla	f
Marzena	f
Mateusz	m
Maurycy	m
Metody	m
Michal	m
Michalina	f
Mieczyslaw	m
Mieczyslawa	f
Mieszko	m
Mikolaj	m
Milogost	m
Miloslaw	m
Milosz	m
Miroslaw	m
Miroslawa	f
Mscislaw	m
Nadzieja	f
Narcyz	m
Natasza	f
Nikodem	m
Ola	f
Olek	m
Oliwia	f
Otylia	f
Patrycja	f
Patryk	m
Pawel	m
Piotr	m
Przemek	m
Przemko	m
Przemo	m
Przemysl	m
Przemyslaw	m
Raclaw	m
Radomil	m
Radomila	f
Radoslaw	m
Radoslawa	f
Radzim	m
Radzimierz	m
Rafal	m
Róza	f
Ruta	f
Ryszard	m
Salomea	f
Serafin	m
Sergiusz	m
Seweryn	m
Seweryna	f
Slawomir	m
Slawomira	f
Sobieslaw	m
Sobieslawa	f
Stanislaw	m
Stanislawa	f
Stefcia	f
Sulislaw	m
Swietomierz	m
Swietopelk	m
Swietoslaw	m
Sylwester	m
Sylwia	f
Szczepan	m
Szczesny	m
Szymon	m
Tadeusz	m
Teodozja	f
Teofil	m
Tobiasz	m
Tomasz	m
Tomek	m
Tymon	m
Tymoteusz	m
Tytus	m
Uriasz	m
Urszula	f
Waclaw	m
Waclawa	f
Waldek	m
Waldus	m
Walenty	m
Walentyna	f
Waleria	f
Walerian	m
Walery	m
Wawrzyniec	m
Wera	f
Weronika	f
Wielislaw	m
Wieslaw	m
Wieslawa	f
Wiktor	m
Wiktoria	f
Wincenty	m
Wiola	f
Wioleta	f
Wioletta	f
Wislaw	m
Wislawa	f
Wit	m
Witold	m
Wladyslaw	m
Wladyslawa	f
Wlodek	m
Wlodzimierz	m
Wlodzislaw	m
Wojciech	m
Wojciecha	f
Wojtek	m
Zachariasz	m
Zbigniew	m
Zdzislaw	m
Zdzislawa	f
Ziemowit	m
Zofia	f
Zosia	f
Zygfryd	m
Zygmunt	m
Aabraham	f
Dawid	m
Anka	f
Antoni	m
Irenka	f
Izabela	f
Jakub	m
Jarek	m
Berta	f
Marian	m
Dorota	f
Kornel	m
Marek	m
Irena	f
Kasper	m
Janina	f
Witold	m
Alfreda	f
Beata	f
Kinga	f
Lidia	f
Natalia	f
Eligia	f
Zuzanna	f
Luiza	f
Ania	f
Bogdan	m
Bogdana	f
Aron	m
Karolina	f
Estera	f
Karol	m
Klaudia	f
Rajmund	m
Aleksander	m
Borys	m
Cezar	m
Gabriela	f
Filipa	f
Nikifor	m
Nina	f
Miron	m
Roksana	f
Roman	m
Aleksandra	f
Igor	m
Olga	f
Tatiana	f
Feliks	m
Filip	m
Hanna	f
Oskar	m
Klara	f
Karina	f
Albin	m
Teodor	m
Tekla	f
Marta	f
Ariadna	f
Marcela	f
Paulina	f
Teresa	f
Natalka	f
Iwan	m
