Alícia	f
Núria	f
Juliana	f
Lucas	m
Xavier	m
Alice	f
Victor	m
Abel	m
Samuel	m
Ida	f
Daniel	m
David	m
Clarissa	f
Monica	f
Gloria	f
Virginia	f
Sonia	f
Irene	f
Lucinda	f
Calista	f
Rita	f
Diana	f
Laura	f
Patricia	f
Amanda	f
Matias	m
Gabriel	m
André	m
Odilon	m
Salomé	f
Alexandre	m
César	m
Noé	m
Magda	f
Helena	f
Gisela	f
Paula	f
Augusta	f
Elisa	f
Daniela	f
Artur	m
Alexandra	f
Martina	f
Elias	m
Sara	f
Valéria	f
Amália	f
Natália	f
Sandra	f
Albertina	f
Clara	f
Adriano	m
Cristiana	f
Cristiano	m
Fabiano	m
Germano	m
Gilda	f
Mafalda	f
Mauro	m
Pio	m
Raul	m
Alda	f
Aldo	m
Lia	f
Maria	mf
Severina	f
Liana	f
Catarina	f
Iolanda	f
Carla	f
Adelina	f
Danilo	m
Adalberto	m
Alberto	m
Alfredo	m
Anacleto	m
Anselmo	m
Aurelio	m
Benigno	m
Bernardino	m
Bernardo	m
Bonifacio	m
Celio	m
Celso	m
Cipriano	m
Clementina	f
Cleto	m
Donato	m
Elpidio	m
Emiliana	f
Emilio	m
Ernesto	m
Eufemia	f
Fausto	m
Feliciano	m
Fortunato	m
Gervasio	m
Gilberto	m
Glauco	m
Gustavo	m
Leopoldo	m
Luciano	m
Marco	m
Mariano	m
Micaela	f
Narciso	m
Nicodemo	m
Primo	m
Remigio	m
Renato	m
Roberto	m
Rodolfo	m
Rufino	m
Sergio	m
Severino	m
Silvio	m
Tacito	m
Teodoro	m
Timoteo	m
Valerio	m
Fabiana	f
Luciana	f
Filomena	f
Carolina	f
Marisa	f
Eva	f
Aurora	f
Lino	m
Renata	f
Marina	f
Leonardo	m
Fortunata	f
Cristina	f
Adriana	f
Sabina	f
Liliana	f
Silvia	f
Teodora	f
Sofia	f
Luiza	f
Abílio	m
Adão	m
Agostinho	m
Aloisio	m
Amélia	f
Anabela	f
Andreia	f
Ângela	f
António	m
Assunção	f
Atílio	m
Balduíno	m
Bárbara	f
Benedita	f
Benedito	m
Benjamim	m
Bento	m
Bia	f
Caetano	m
Carmo	m
Cátia	f
Célia	f
Chica	f
Chico	m
Cíntia	f
Cláudia	f
Cláudio	m
Constança	f
Constância	f
Cornélio	m
Cristóvão	m
Demétrio	m
Desidéria	f
Desidério	m
Dinis	m
Diniz	m
Diogo	m
Dionísio	m
Domingos	m
Dorotéia	f
Duarte	m
Edite	f
Eduarda	f
Efigênia	f
Elder	m
Elisabete	f
Enéas	m
Érica	f
Érico	m
Estevão	m
Eugênia	f
Eugênio	m
Eulália	f
Eusébio	m
Fábia	f
Fábio	m
Felicidade	f
Fernão	m
Filipe	m
Flávia	f
Flávio	m
Frederico	m
Gertrudes	f
Gláucia	f
Gláucio	m
Gonçalo	m
Graça	f
Gualberto	m
Gualter	m
Guilherme	m
Heitor	m
Hélder	m
Helder	m
Henrique	m
Hermínia	f
Hermínio	m
Horácio	m
Imaculada	f
Inácio	m
Inês	f
Íris	f
Jerônimo	m
João	m
Josué	m
Judite	f
Leocádia	f
Lídia	f
Lígia	f
Lílian	f
Lívia	f
Lourenço	m
Lúcia	f
Lúcio	m
Luís	m
Luísa	f
Luzia	f
Lygia	f
Madalena	f
Marcelinho	m
Márcia	f
Márcio	m
Mário	m
Martinho	m
Mateus	m
Maurício	m
Mônica	f
Neves	f
Noêmia	f
Nuno	m
Ofélia	f
Olavo	m
Olegário	m
Otávio	m
Ovídio	m
Plínio	m
Rogério	m
Roldão	m
Ronaldo	m
Rosana	f
Rosário	f
Rui	m
Rute	f
Salomão	m
Sebastião	m
Simão	m
Tadeu	m
Tânia	f
Téo	m
Teodósio	m
Teresinha	f
Terezinha	f
Tiago	m
Tomé	m
Tristão	m
Ulisses	m
Úrsula	f
Veríssimo	m
Verônica	f
Vinícius	m
Virgílio	m
Viriato	m
Vítor	m
Vitória	f
Zé	m
Zeferino	m
Joana	f
Joaquim	m
Quim	m
Frederica	f
Cosme	m
Afonso	m
Bartolomeu	m
Dores	f
Iria	f
Margarida	f
Nicolau	m
Paulo	m
Júlia	f
Cezar	m
Gabriela	f
Filipa	f
Emília	f
Antónia	f
Cecília	f
Olívia	f
Amílcar	m
Calisto	m
Estela	f
Fátima	f
Isaura	f
Lurdes	f
Priscila	f
Reinaldo	m
Rosalina	f
Telma	f
Telmo	m
Amando	m
Vera	f
Olga	f
Tatiana	f
Valter	m
Ester	f
Armando	m
Augusto	m
Celestino	m
Evaristo	m
Faustino	m
Modesto	m
Osvaldo	m
Palmira	f
Rolando	m
Saturnino	m
Susana	f
Marta	f
Benigna	f
Rosa	f
Álvaro	m
Amancio	m
Ambrosio	m
América	f
Américo	m
Aníbal	m
Beatriz	f
Calixta	f
Calixto	m
Camila	f
Camilo	m
Carlito	m
Carlitos	m
Carlos	m
Carlota	f
Cruz	mf
Dimas	m
Domitila	f
Dulce	f
Edmundo	m
Eduardo	m
Eleuterio	m
Eustaquio	m
Ezequiel	m
Fabricio	m
Felipe	m
Fernanda	f
Fernando	m
Florencio	m
Francisco	m
Genoveva	f
Geraldo	m
Gil	m
Godofredo	m
Graciana	f
Graciano	m
Guiomar	mf
Heliodoro	m
Herberto	m
Heriberto	m
Hermenegildo	m
Hipólito	m
Jacinta	f
Jacinto	m
Jaime	m
Jorge	m
José	m
Jovita	f
Julio	m
Leonor	f
Leticia	f
Marcelino	m
Marcelo	m
Marcos	m
Matilde	f
Maximiano	m
Maximiliano	m
Maximino	m
Miguel	m
Miguela	f
Moisés	m
Natanael	m
Nilda	f
Noemí	f
Óscar	m
Patricio	m
Paulino	m
Pedro	m
Plácido	m
Rafaela	f
Raimundo	m
Rebeca	f
Ricardo	m
Roque	m
Ruy	m
Santiago	m
Sol	f
Teófilo	m
Tiburcio	m
Vicente	m
Victorino	m
Josefa	f
Raquel	f
Hugo	m
Isabel	f
Débora	f
Manuel	m
Rafael	m
Tomás	m
Arsenio	m
Casimiro	m
Cecilio	m
Leandro	m
Lorena	f
Teobaldo	m
Vasco	m
Teresa	f
Rodrigo	m
Gaspar	m
Francisca	f
Isabela	f
Mariana	f
Manuela	f
Ana	f
Ema	f
