Flora	f
Camilla	f
Diana	f
Evander	m
Pluto	m
Rhea	f
Maia	f
Aurora	f
Silvia	f
Silvius	m
Aeneas	m
Amulius	m
Angerona	f
Aries	m
Bellona	f
Cardea	f
Ceres	f
Concordia	f
Consus	m
Cupid	m
Dido	f
Elissa	f
Evandrus	m
Fauna	f
Faunus	m
Felicitas	f
Gemini	m
Hercules	m
Hersilia	f
Italus	m
Janus	m
Jove	m
Juno	f
Jupiter	m
Juturna	f
Juventas	f
Laverna	f
Lavinia	f
Liber	m
Libitina	f
Lucina	f
Luna	f
Maia	f
Mars	m
Mercury	m
Naenia	f
Neptunus	m
Nona	f
Numitor	m
Pax	f
Pollux	m
Pomona	f
Proserpina	f
Proserpine	f
Romulus	m
Salacia	f
Saturnus	m
Summanus	m
Terminus	m
Venus	f
Vesta	f
Victoria	f
Vulcan	m
Tatius	m
Silvanus	m
Minerva	f
Ulysses	m
Quirinus	m
Remus	m
