Nikon	m
Platon	m
Ekaterina	f
Evdokiya	f
Evgeni	m
Evgeniya	f
Yana	f
Stanimir	m
Boris	m
Radoslava	f
Miloslava	f
Mstislav	m
Milena	f
Milan	m
Radoslav	m
Miloslav	m
Miroslava	f
Miroslav	m
Stanislava	f
Stanislav	m
Dominika	f
Adam	m
Martin	m
Albert	m
Robert	m
David	m
Angela	f
Anna	f
Adrian	m
Lana	f
Mark	m
Liza	f
Diana	f
Denis	m
Konstantin	m
Artur	m
Benedikt	m
Isidor	m
Eduard	m
Anton	m
Nestor	m
Spiridon	m
Spyridon	m
Yakov	m
Timur	m
Marianna	f
Angelina	f
Antonina	f
Violetta	f
Valentina	f
Elena	f
Eva	f
Marina	f
Sabina	f
Agata	f
Susanna	f
Katerina	f
Ania	f
Bogdan	m
Bogdana	f
Andrei	m
Abram	m
Afanasiy	m
Afanasy	m
Agafya	f
Aglaya	f
Agnessa	f
Agrafena	f
Akilina	f
Akim	m
Aksinya	f
Akulina	f
Aleksandr	m
Aleksei	m
Aleksey	m
Alexei	m
Alexey	m
Alisa	f
Allochka	f
Alyona	f
Alyosha	m
Anatoli	m
Anatoliy	m
Anatoly	m
Anfisa	f
Anisim	m
Annushka	f
Anushka	f
Anya	f
Anzhela	f
Anzhelina	f
Apollinariya	f
Arina	f
Arisha	f
Aristarkh	m
Arkadi	m
Arkadiy	m
Arkady	m
Arkhip	m
Arseni	m
Arseniy	m
Artyom	m
Asya	f
Avdotya	f
Borya	m
Daniil	m
Darya	f
Demyan	m
Desya	m
Dima	m
Dmitri	m
Dmitrii	m
Dmitriy	m
Dmitry	m
Dorofei	m
Dorofey	m
Dunya	f
Dunyasha	f
Elizaveta	f
Ermolai	m
Esfir	f
Evgeniy	m
Evgeny	m
Evpraksiya	f
Faddei	m
Faddey	m
Faina	f
Fedor	m
Fedora	f
Fedot	m
Fedya	m
Feodor	m
Feodora	f
Feodosiy	m
Feofan	m
Feofil	m
Feofilakt	m
Ferapont	m
Filat	m
Filipp	m
Fima	m
Foka	m
Foma	m
Fyodor	m
Gala	f
Galya	f
Gavriila	f
Gena	m
Gennadi	m
Gennadiy	m
Gennadiya	f
Gennady	m
Genya	m
Georgiy	m
Georgy	m
Gerasim	m
German	m
Germogen	m
Gleb	m
Grigori	m
Grigoriy	m
Grigory	m
Grisha	m
Grusha	f
Illarion	m
Ilya	m
Inna	f
Innokenti	m
Innokentiy	m
Ioann	m
Ipati	m
Ippolit	m
Ira	f
Irinei	m
Iriney	m
Irinushka	f
Isay	m
Jekaterina	f
Karp	m
Katenka	f
Katia	f
Katya	f
Kazimir	m
Kenya	m
Khariton	m
Kir	m
Kira	f
Kirill	m
Klava	f
Klavdiya	f
Kolya	m
Kostya	m
Kseniya	f
Kuzma	m
Lavrenti	m
Lavrentiy	m
Lavrenty	m
Leonid	m
Leonti	m
Leonty	m
Lev	m
Lidochka	f
Liouba	f
Lizaveta	f
Lyosha	m
Lyov	m
Makar	m
Makari	m
Makariy	m
Maks	m
Maksim	m
Maksimilian	m
Manya	f
Marfa	f
Marlen	m
Marya	f
Maryana	f
Masha	f
Matfey	m
Matrona	f
Matryona	f
Matvei	m
Matvey	m
Maxim	m
Mefodiy	m
Melor	m
Misha	m
Mitrofan	m
Mitya	m
Modest	m
Modya	m
Moisey	m
Motya	mf
Nadya	f
Nastasia	f
Nastasya	f
Nastya	f
Nata	f
Natalya	f
Nazariy	m
Nika	mf
Nikita	m
Nikodim	m
Nina (4)	f
Ninel	f
Nonna	f
Oleg	m
Olya	f
Onisim	m
Osip	m
Pankrati	m
Pasha	m
Patya	m
Pelageya	f
Praskoviya	f
Praskovya	f
Prokhor	m
Prokopy	m
Pyotr	m
Radimir	m
Raisa	f
Rodion	m
Rodya	m
Rolan	m
Ruf	f
Rurik	m
Ruslan	m
Sasha	mf
Saveli	m
Saveliy	m
Savely	m
Savva	m
Semyon	m
Serafima	f
Sevastian	m
Sevastyan	m
Shura	mf
Sofya	f
Stas	m
Stasya	f
Stepan	m
Sveta	f
Svyatopolk	m
Svyatoslav	m
Syuzanna	f
Taisiya	f
Tatyana	f
Terenti	m
Tikhon	m
Timofei	m
Timofey	m
Tit	m
Toma	f
Tsetsiliya	f
Uliana	f
Ustinya	f
Vadik	m
Vadim	m
Valeri	m
Valeriy	m
Valeriya	f
Valery	m
Vanya	m
Varfolomei	m
Varfolomey	m
Varlaam	m
Varlam	m
Varya	f
Vasili	m
Vasilisa	f
Vasiliy	m
Vasily	m
Vaska	m
Vassily	m
Vasya	m
Veniamin	m
Venyamin	m
Verochka	f
Verusha	f
Vikenti	m
Vilen	m
Vitali	m
Vitaliy	m
Vitaly	m
Vitya	m
Vladilen	m
Vladlen	m
Vlasi	m
Volodya	m
Vova	m
Vsevolod	m
Vyacheslav	m
Yakim	m
Yaromir	m
Yaropolk	m
Yaroslav	m
Yaroslava	f
Yasha	m
Yefim	m
Yefrem	m
Yegor	m
Yekaterina	f
Yelena	f
Yelizaveta	f
Yemelyan	m
Yermolai	m
Yesfir	f
Yevdokiya	f
Yevgeni	m
Yevgeniy	m
Yevgeniya	f
Yevgeny	m
Yevpraksiya	f
Yuli	m
Yulia	f
Yulianna	f
Yuliy	m
Yustina	f
Zakhar	m
Zhanna	f
Zhannochka	f
Zina	f
Zinaida	f
Zinoviy	m
Zinoviya	f
Zoya	f
Rufina	f
Yeva	f
Aleksandrina	f
Andrey	m
Galina	f
Kliment	m
Lidiya	f
Lyudmila	f
Mikhail	m
Nadejda	f
Nadezhda	f
Naum	m
Nikolai	m
Petia	mf
Petya	mf
Polina	f
Rada	f
Samuil	m
Sergei	m
Sergej	m
Sergey	m
Yulian	m
Yuliana	f
Yuliya	f
Zhenya	mf
Ludmilla	f
Snezhana	f
Irina	f
Ilia	m
Nikifor	m
Borislav	m
Borislava	f
Lazar	m
Lyubov	f
Viktoriya	f
Ivan	m
Boleslava	f
Rostislav	m
Vladislava	f
Pavel	m
Boleslav	m
Veronika	f
Vladislav	m
Natasha	f
Sonya	f
Tamara	f
Tanya	f
Tasha	f
Vera	f
Lara	f
Ilari	m
Dimitri	m
Isaak	m
Gavriil	m
Larisa	f
Varvara	f
Filippa	f
Nina	f
Varnava	m
Miron	m
Roksana	f
Roman	m
Aleksandra	f
Igor	m
Serafim	m
Vlad	m
Iosif	m
Olga	f
Luka	m
Vladimir	m
Tatiana	f
Svetlana	f
Slava	mf
Vladimira	f
Roza	f
Feliks	m
Alla	f
Lesya	f
Lilia	f
Lilya	f
Luba	f
Lyuba	f
Lyubochka	f
Nataliya	f
Nazar	m
Sofiya	f
Yuri	m
Yuriy	m
Anastasiya	f
Liliya	f
Mariya	f
Valentin	m
Viktor	m
Inga	f
Lena	f
Klara	f
Karina	f
Kristina	f
Tekla	f
Radomir	m
Anastas	m
Margarita	f
Selena	f
Oksana	f
Oxana	f
Taras	m
