Aleksandar	m
Stanimir	m
Todor	m
Ivo	m
Andrija	m
Dmitar	m
Dobroslav	m
Dubravka	f
Dubravko	m
Ljuba	m
Ljubomir	m
Mirna	f
Mladenka	f
Srecko	m
Stjepan	m
Tihana	f
Tijana	f
Tomislav	m
Tomislava	f
Vedran	m
Vedrana	f
Velimir	m
Vinja	f
Zlatan	m
Toma	m
Goran	m
Ognjan	m
Vlatko	m
Jagoda	f
Antonija	f
Dijana	f
Drago	m
Jasna	f
Javor	m
Ljubica	f
Marijana	f
Mirjana	f
Mirko	m
Slavko	m
Vesna	f
Zlata	f
Zlatko	m
Mladen	m
Zdravko	m
Darko	m
Zoran	m
Suzana	f
Marija	f
Radoslava	f
Iva	f
Milena	f
Milan	m
Mila	f
Radoslav	m
Duana	f
Duan	m
Ivana	f
Dalibor	m
Zora	f
Miroslava	f
Miroslav	m
Stanislav	m
Milo	m
Ivanka	f
Mirjam	f
Oliver	m
Simo	m
Tanja	f
Konstantin	m
Emil	m
Stefan	m
Sonja	f
Katarina	f
Maja	f
Maja	f
Danilo	m
Marina	f
Jelena	f
Emilija	f
Ilija	m
Stojan	m
Anka	f
Irena	f
Bogdan	m
Bogdana	f
Filipa	f
Borislav	m
Borislava	f
Lazar	m
Ivan	m
Vladislav	m
Aleksandra	f
Olga	f
Luka	m
Vladimir	m
Svetlana	f
Filip	m
Viktor	m
Teodor	m
Kristina	f
Andjela	f
Antonije	m
Boa	m
Dimitrije	m
Djordje	m
Dragoslava	f
Josif	m
Jovana	f
Jovanka	f
Mateja	m
Mihailo	m
Mihajlo	m
Miloje	m
Milojica	m
Nebojsa	m
Nemanja	m
Obrad	m
Olivera	f
Pavle	m
Predrag	m
Radmilo	m
Radomira	f
Senka	f
Sneana	f
Stevan	m
Uros	m
Vasilije	m
Veca	f
Vladan	m
Vuk	m
Vukasin	m
Sava	m
Gordana	f
Nenad	m
Pero	m
Petar	m
Sofija	f
Dragana	f
Dragomir	m
Dejan	m
Dejana	f
Dragica	f
Dragoslav	m
Dunja	f
Kristijan	m
Milka	f
Nada	f
Nataa	f
Slavica	f
Nikola	m
Tatjana	f
Natalija	f
Valerija	f
Dragan	m
Danica	f
Radmila	f
Boidar	m
Biljana	f
Jovan	m
Slobodan	m
Radomir	m
Milica	f
Uro	m
Isidora	f
Radovan	m
Danijel	m
Danijela	f
Draga	f
Janko	m
Matija	m
Bojan	m
Bojana	f
Adrijana	f
Marta	f
Ana	f
Marko	m
