Juraj	m
Duana	f
Duan	m
Albína	f
Alexej	m
Apolena	f
Barbora	f
Bohumil	m
Bohumír	m
Drahoslav	m
Elika	f
Hana	f
Havel	m
Iveta	f
Ivona	f
Jarmila	f
Jaroslav	m
Jaroslava	f
Jolana	f
Joná	m
Judita	f
Klement	m
Ladislava	f
Lenka	f
Lubomír	m
Lubo	m
Markéta	f
Michal	m
imon	m
Slavomír	m
Sona	f
Tadeá	m
Tomá	m
Václav	m
Vendelín	m
Vít	m
Vladimír	m
Vladimíra	f
Zuzana	f
Darina	f
Dalibor	m
Zora	f
Kazimír	m
Magdaléna	f
Marika	f
Kamil	m
Kamila	f
Blanka	f
Denisa	f
Miloslav	m
Miroslava	f
Miroslav	m
Stanislava	f
Stanislav	m
Milo	m
Ale	m
Boena	f
Ladislav	m
Dominik	m
Dominika	f
Bohuslav	m
Jana	f
Cyril	m
Linda	f
Vincent	m
Adam	m
Martin	m
Andrea	f
Alexander	m
Peter	m
Angela	f
Anna	f
Matilda	f
Gabriel	m
René	m
Marcel	m
Denis	m
Koloman	m
Nikola	f
Alena	f
Helena	f
Silvester	m
Aurel	m
Eugen	m
Eduard	m
Monika	f
Alexandra	f
Martina	f
Michaela	f
Olympia	f
Beáta	f
Konrád	m
Renáta	f
Sára	f
Tibor	m
Amália	f
Natália	f
Dávid	m
Margita	f
Mária	f
Melánia	f
Terézia	f
Viktória	f
Marianna	f
Zita	f
Lucia	f
Romana	f
Adriana	f
Silvia	f
Dorota	f
Kornel	m
Marek	m
Estera	f
Karol	m
Klaudia	f
Júlia	f
Gabriela	f
Emília	f
Antónia	f
Cecília	f
Olívia	f
Boleslav	m
Veronika	f
Roman	m
Tatiana	f
Svetlana	f
Viktor	m
Teodor	m
Nikola	m
Danica	f
Alica	f
Alojzia	f
Albeta	f
Anastázia	f
Bartolomej	m
Dionýz	m
Hedviga	f
Ján	m
Július	m
Justína	f
Katarína	f
Kristína	f
Lýdia	f
Matú	m
Maximilián	m
Nadeda	f
Ondrej	m
Patrícia	f
Pavol	m
tefánia	f
Valentína	f
Vavrinec	m
Viliam	m
Vojtech	m
ofia	f
Augustín	m
Mikulá	m
Marián	m
Radovan	m
Jozef	m
Matej	m
Zdenka	f
Zdenko	m
Andrej	m
Alojz	m
Kritof	m
Metod	m
tefan	m
Timotej	m
Benjamín	m
Vilma	f
Marta	f
Ema	f
Valentín	m
