Mira	f
Boris	m
Silva	f
Antonija	f
Dijana	f
Drago	m
Jasna	f
Javor	m
Ljubica	f
Marijana	f
Mirjana	f
Mirko	m
Slavko	m
Vesna	f
Zlata	f
Zlatko	m
Mladen	m
Zdravko	m
Darko	m
Zoran	m
Suzana	f
Josip	m
Marijan	m
Silvija	f
Vinko	m
Marija	f
Iva	f
Milena	f
Milan	m
Duan	m
Ivana	f
Zora	f
Miroslava	f
Miroslav	m
Stanislava	f
Stanislav	m
Milo	m
Ale	m
Boena	f
Ladislav	m
Dominik	m
Dominika	f
Hedvika	f
Ludvik	m
Pavla	f
Pavlina	f
Vincenc	m
Ivanka	f
Edita	f
Nikolaj	m
Urban	m
Karel	m
Jana	f
Mirjam	f
Jan	m
Herman	m
Martin	m
Albert	m
Robert	m
Simon	m
Ernest	m
Justin	m
Peter	m
Tim	m
Herbert	m
Leon	m
Ida	f
Daniel	m
David	m
Barbara	f
Angela	f
Tina	f
Justina	f
Laura	f
Kristjan	m
Denis	m
Alena	f
Leopold	m
Rudolf	m
Helena	f
Lea	f
Magdalena	f
Silvester	m
Tanja	f
Ferdinand	m
Irma	f
Daniela	f
Artur	m
Anton	m
Emil	m
Monika	f
Martina	f
Jakob	m
Sonja	f
Katarina	f
Konrad	m
Maja	f
Maja	f
Margareta	f
Gregor	m
Katja	f
Nadja	f
Petra	f
Sara	f
Marica	f
Jozefa	f
Vili	m
Simona	f
Sandra	f
Albina	f
Romana	f
Danilo	m
Valentina	f
Pia	f
Silvestra	f
Eva	f
Renata	f
Sabina	f
Agata	f
Rozalija	f
Emilija	f
Viktorija	f
Stojan	m
Berta	f
Irena	f
Bogdan	m
Bogdana	f
Karolina	f
Rajmund	m
Aleksander	m
Mihaela	f
Ivan	m
Pavel	m
Veronika	f
Vladislav	m
Vera	f
Lara	f
Nina	f
Roman	m
Aleksandra	f
Igor	m
Olga	f
Luka	m
Vladimir	m
Slava	mf
Vladimira	f
Roza	f
Feliks	m
Filip	m
Erik	m
Erika	f
Anja	f
Tea	f
Edvard	m
Valentin	m
Viktor	m
Henrik	m
Oskar	m
Klara	f
Albin	m
Valter	m
Teodor	m
Kristina	f
Dragomir	m
Dejan	m
Dejana	f
Dragica	f
Dragoslav	m
Dunja	f
Kristijan	m
Milka	f
Nada	f
Nataa	f
Slavica	f
Nikola	m
Tatjana	f
Natalija	f
Valerija	f
Dragan	m
Danica	f
Boidar	m
Milica	f
Uro	m
Matej	m
Zdenka	f
Zdenko	m
Aleks	m
Aleksej	m
Alenka	f
Alfonz	m
Alojzij	m
Alojzija	f
Amalija	f
Andra	m
Andreja	f
Anica	f
Apolonija	f
Avgust	m
Avgusta	f
Avgutin	m
Bla	m
Bogomir	m
Borut	m
Botjan	m
Cecilija	f
Cilka	f
Ciril	m
Cirila	f
Cvetka	f
Cvetko	m
Damijan	m
Damijana	f
Damjan	m
Darinka	f
Dimitrij	m
Domen	m
Doroteja	f
Edi	m
Elizabeta	f
Franc	m
Franciek	m
Francika	f
Francka	f
Friderik	m
Gaper	m
Ignac	m
Ignacij	m
Izidor	m
Jaka	m
Janez	m
Jernej	m
Joe	m
Joef	m
Joefa	f
Joica	f
Julij	m
Julijana	f
Jurij	m
Katica	f
Klavdija	f
Klemen	m
Ksenija	f
Lavra	f
Lilijana	f
Ljudmila	f
Lojze	m
Lovrenc	m
Lovro	m
Marjeta	f
Mateja	f
Matev	m
Matja	m
Miha	m
Mihael	m
Miklav	m
Miran	m
Miro	m
Mitja	m
Nejc	m
Nea	f
Nika	f
Pepca	f
Polona	f
Primo	m
Rihard	m
Rok	m
Saa	f
Sao	m
Sebastijan	m
Sebastjan	m
Slavka	f
pela	f
Srecko	m
Tadej	m
Teja	f
Terezija	f
Tinek	m
Tjaa	f
Toma	m
Tone	m
Tonka	f
Urka	f
Urula	f
Vida	f
Viljem	m
Vilko	m
Zala	f
an	m
iga	m
iva	f
Jelka	f
Jure	m
Lucija	f
Marjan	m
Marjana	f
Mojca	f
Stanka	f
Stanko	m
Julija	f
Danijel	m
Danijela	f
Draga	f
Janko	m
Matija	m
Darja	f
Andrej	m
Jolanda	f
Vid	m
Bojan	m
Bojana	f
Adrijana	f
Alojz	m
Kritof	m
Metod	m
tefan	m
Timotej	m
Marta	f
Rafael	m
Ana	f
Ema	f
Marko	m
