Andile	m
Boipelo	mf
Boitumelo	mf
Bongani	m
Chipo	f
Dakarai	m
Dikeledi	f
Dumisani	mf
Farai	mf
Fungai	m
Hlengiwe	f
Itumeleng	mf
Kagiso	f
Katlego	mf
Kefilwe	mf
Kgosi	m
Lerato	f
Lesedi	f
Lindiwe	f
Lungile	f
Masozi	mf
Mbali	f
Melisizwe	m
Mudiwa	mf
Munashe	mf
Neo	mf
Nkosana	m
Nkosazana	f
Nomusa	f
Nontle	f
Nosipho	f
Nosizwe	f
Nthanda	mf
Ntombi	f
Nyarai	f
Paki	m
Refilwe	mf
Rudo	mf
Rufaro	f
Rumbidzai	f
Rutendo	mf
Sekai	f
Sethunya	f
Sibonakaliso	f
Sipho	m
Sithembile	mf
Sizwe	m
Tafadzwa	mf
Taonga	mf
Tapiwa	f
Tariro	f
Tatenda	mf
Tau	m
Tendai	f
Thabo	m
Thandiwe	f
Themba	mf
Thulani	m
Thulile	f
Tichaona	m
Tinashe	mf
Tsholofelo	f
Tumelo	mf
Unathi	mf
Xolani	m
Zola	f
