Hilaria	f
Hortensia	f
Saturnina	f
Septima	f
Varinia	f
Amaya	f
Itziar	f
Mireia	f
Juliana	f
Amalia	f
Dorita	f
Nidia	f
Nydia	f
Lucas	m
Georgina	f
Esther	f
Abel	m
Samuel	m
Claudia	f
Ida	f
Julia	f
Judith	f
Daniel	m
David	m
Roberta	f
Olivia	f
Delia	f
Gloria	f
Virginia	f
Sonia	f
Irene	f
Cecilia	f
Calista	f
Ursula	f
Rita	f
Adelia	f
Alma	f
Dora	f
Esmeralda	f
Griselda	f
Marcia	f
Felicia	f
Celia	f
Amelia	f
Diana	f
Laura	f
Adela	f
Patricia	f
Amanda	f
Roxana	f
Victoria	f
Gabriel	m
Félix	m
César	m
Noé	m
Gisela	f
Magdalena	f
Paula	f
Irma	f
Anselma	f
Elisa	f
Daniela	f
Martina	f
Marita	f
Sara	f
Judit	f
Clara	f
Carla	f
Adelina	f
Danilo	m
Adolfo	m
Alba	f
Armida	f
Arturo	m
Basilio	m
Carmela	f
Carmina	f
Ciriaco	m
Cirino	m
Ciro	m
Claudio	m
Clemente	m
Delfina	f
Demetrio	m
Desiderio	m
Eliana	f
Eligio	m
Eliseo	m
Ernesta	f
Eugenio	m
Fabio	m
Flavio	m
Gerardo	m
Gregorio	m
Imelda	f
Lorenza	f
Lorenzo	m
Lucio	m
Mario	m
Nazario	m
Orfeo	m
Ovidio	m
Paola	f
Perla	f
Perlita	f
Plinio	m
Porfirio	m
Prospero	m
Robertina	f
Severiano	m
Severo	m
Tecla	f
Teo	m
Teodosio	m
Tito	m
Urbano	m
Vinicio	m
Virgilio	m
Vito	m
Elena	f
Antonia	f
Fabiola	f
Isabella	f
Bibiana	f
Desideria	f
Maura	f
Viviana	f
Melania	f
Adalberto	m
Alberto	m
Alfredo	m
Anacleto	m
Anselmo	m
Aurelio	m
Benigno	m
Bernardino	m
Bernardo	m
Bonifacio	m
Celio	m
Celso	m
Cipriano	m
Clementina	f
Cleto	m
Donato	m
Elpidio	m
Emiliana	f
Emilio	m
Ernesto	m
Eufemia	f
Fausto	m
Feliciano	m
Fortunato	m
Gervasio	m
Gilberto	m
Glauco	m
Gustavo	m
Leopoldo	m
Luciano	m
Marco	m
Mariano	m
Micaela	f
Narciso	m
Nicodemo	m
Primo	m
Remigio	m
Renato	m
Roberto	m
Rodolfo	m
Rufino	m
Sergio	m
Severino	m
Silvio	m
Tacito	m
Teodoro	m
Timoteo	m
Valerio	m
Fabiana	f
Luciana	f
Filomena	f
Carolina	f
Marisa	f
Eva	f
Aurora	f
Lino	m
Renata	f
Marina	f
Leonardo	m
Fortunata	f
Cristina	f
Adriana	f
Sabina	f
Liliana	f
Silvia	f
Teodora	f
Flavia	f
Emilia	f
Valeria	f
Eugenia	f
Olimpia	f
Dorotea	f
Agata	f
Rayen	f
Xochitl	f
Berta	f
Lidia	f
Natalia	f
Gabriela	f
Amílcar	m
Calisto	m
Estela	f
Fátima	f
Isaura	f
Lurdes	f
Priscila	f
Reinaldo	m
Rosalina	f
Telma	f
Telmo	m
Amando	m
Violeta	f
Ileana	f
Olga	f
Tatiana	f
Ester	f
Isidora	f
Aarón	m
Abigaíl	f
Adán	m
Adora	f
Adrián	m
Águeda	f
Agustín	m
Alejandra	f
Alejandro	m
Alejo	m
Almudena	f
Alondra	f
Alonso	m
Amada	f
Amado	m
Amarilis	f
Amparo	f
Anabel	f
Anabella	f
Andrés	m
Ángel	m
Ángela	f
Angélica	f
Angelita	f
Anunciación	f
Apolinar	m
Araceli	f
Aracelis	f
Aracely	f
Arcelia	f
Ascensión	f
Asdrubal	m
Asun	f
Asunción	f
Atilio	m
Aureliano	m
Azeneth	f
Azucena	f
Baldomero	m
Balduino	m
Baltasar	m
Bartolomé	m
Baudelio	m
Bautista	m
Belén	f
Benita	f
Bernardita	f
Bienvenida	f
Blanca	f
Blas	m
Bolivar	m
Cande	mf
Candela	f
Candelaria	f
Candelario	m
Candelas	f
Caridad	f
Carmelita	f
Catalina	f
Catherina	f
Cayetano	m
Cebrián	m
Ceferino	m
Charo	f
Che	m
Chelo	f
Chimo	m
Chita	f
Chucho	m
Chus	mf
Chuy	m
Clarisa	f
Clímaco	m
Concepción	f
Concha	f
Conchita	f
Conrado	m
Constanza	f
Consuela	f
Consuelo	f
Crescencia	f
Cristián	m
Cristóbal	m
Cruzita	f
Curro	m
Custodia	f
Custodio	m
Dania	f
Darío	m
Desi	m
Diego	m
Dominga	f
Domingo	m
Eberardo	m
Edelmira	f
Edelmiro	m
Edgardo	m
Efraín	m
Eladio	m
Elías	m
Elodia	f
Eloísa	f
Eloy	m
Elvira	f
Emelina	f
Emigdia	f
Emigdio	m
Emperatriz	f
Encarna	f
Encarnación	f
Encarnita	f
Enrique	m
Epifanio	m
Ercilia	f
Ernestina	f
Esperanza	f
Espiridión	m
Estavan	m
Esteban	m
Estefanía	f
Estrella	f
Etelvina	f
Eutimio	m
Eutropio	m
Evelia	f
Evita	f
Felicidad	f
Felipa	f
Fermin	m
Fidel	m
Fidela	f
Florinda	f
Fulgencio	m
Gabino	m
Germán	m
Gertrudis	f
Gonzalo	m
Goyo	m
Gracia	f
Graciela	f
Guadalupe	mf
Gualterio	m
Guillermo	m
Héctor	m
Heraclio	m
Herminio	m
Hernán	m
Hernando	m
Horacio	m
Idoya	f
Ignacio	m
Ildefonso	m
Iliana	f
Inés	f
Inez	f
Iñigo	m
Inmaculada	f
Inocencio	m
Isandro	m
Isidro	m
Ismael	m
Iván	m
Ivette	f
Jacobo	m
Jafet	m
Javier	m
Jenaro	m
Jerónimo	m
Jesús	m
Jesusa	f
Jimena	f
Joaquín	m
Joaquina	f
Juana	f
Juanita	f
Juanito	m
Julián	m
Lalo	m
Laurita	f
Leocadia	f
Leocadio	m
León	m
Leoncio	m
Loida	f
Lolita	f
Lope	m
Lucía	f
Lucila	f
Luis	m
Luisina	f
Lupe	f
Lupita	f
Luz	f
Macarena	f
Macaria	f
Macario	m
Maite	f
Manola	f
Manolo	m
Manuelita	f
Marcial	m
Marcio	m
Marianela	f
Maribel	f
Maricela	f
Maricruz	f
Marisela	f
Marisol	f
Maritza	f
Martín	m
Martirio	f
Martita	f
Mateo	m
Matías	m
Mauricio	m
Máxima	f
Máximo	m
Mayte	f
Melchor	m
Melisa	f
Mercedes	f
Merche	f
Milagros	f
Modesta	f
Mónica	f
Nacho	m
Nacio	m
Nando	m
Natalio	m
Nereida	f
Nicolao	m
Nicolás	m
Nicolasa	f
Nieve	f
Nieves	f
Noelia	f
Nohemi	f
Nuria	f
Obdulia	f
Octavio	m
Odalis	mf
Odalys	f
Olalla	f
Olegario	m
Pablo	m
Paca	f
Pacífica	f
Paco	m
Paloma	f
Pancho	m
Pánfilo	m
Paquita	f
Paquito	m
Pascual	m
Pascuala	f
Pastora	f
Paz	f
Pepe	m
Pepita	f
Pepito	m
Perpetua	f
Petrona	f
Pía	f
Piedad	f
Pilar	f
Pili	f
Pío	m
Poncio	m
Primitivo	m
Prudencia	f
Prudencio	m
Quique	m
Rafa	m
Rainerio	m
Ramiro	m
Ramón	m
Raúl	m
Régulo	m
Reina	f
Remedios	f
Reyes	mf
Reyna	f
Reynaldo	m
Rico	m
Rocío	f
Rogelio	m
Roldán	m
Romina	f
Rosalva	f
Rosenda	f
Rosendo	m
Rosita	f
Rubén	m
Rubina	f
Ruperta	f
Ruperto	m
Salomón	m
Salud	f
Salvador	m
Sancha	f
Sanchia	f
Sancho	m
Sandalio	m
Santos	m
Sarita	f
Sebastián	m
Seve	m
Silvestre	m
Simón	m
Socorro	f
Sofía	f
Sofronio	m
Soledad	f
Sosimo	m
Susanita	f
Tadeo	m
Tancredo	m
Teódulo	m
Teófila	f
Tercero	m
Tere	f
Teresita	f
Tomasa	f
Toribio	m
Trini	f
Trinidad	mf
Tristán	m
Ulises	m
Valencia	f
Venceslás	m
Verónica	f
Vidal	m
Visitación	f
Wilfredo	m
Ximena	f
Xiomara	f
Xochilt	f
Yago	m
Zacarías	m
Zarita	f
Zoraida	f
Herminia	f
Bethania	f
Víctor	m
Benjamín	m
Alicia	f
Dolores	f
Evangelina	f
Lola	f
Yolanda	f
Carmen	f
Anita	f
Josue	m
María	f
Ricarda	f
Adelaida	f
Vilma	f
Agapito	m
Alfonso	m
Antonietta	f
Antonio	m
Benito	m
Carmelo	m
Celestina	f
Cornelio	m
Dionisio	m
Emiliano	m
Eusebio	m
Federico	m
Isidoro	m
Luisa	f
Ofelia	f
Rosalinda	f
Rosario	mf
Eulalia	f
Feliciana	f
Armando	m
Augusto	m
Celestino	m
Evaristo	m
Faustino	m
Modesto	m
Osvaldo	m
Palmira	f
Rolando	m
Saturnino	m
Susana	f
Marta	f
Benigna	f
Rosa	f
Sabas	m
Florentina	f
Pastor	m
Primitiva	f
Juan	m
Ariadna	f
Marcela	f
Paulina	f
Álvaro	m
Amancio	m
Ambrosio	m
América	f
Américo	m
Aníbal	m
Beatriz	f
Calixta	f
Calixto	m
Camila	f
Camilo	m
Carlito	m
Carlitos	m
Carlos	m
Carlota	f
Cruz	mf
Dimas	m
Domitila	f
Dulce	f
Edmundo	m
Eduardo	m
Eleuterio	m
Eustaquio	m
Ezequiel	m
Fabricio	m
Felipe	m
Fernanda	f
Fernando	m
Florencio	m
Francisco	m
Genoveva	f
Geraldo	m
Gil	m
Godofredo	m
Graciana	f
Graciano	m
Guiomar	mf
Heliodoro	m
Herberto	m
Heriberto	m
Hermenegildo	m
Hipólito	m
Jacinta	f
Jacinto	m
Jaime	m
Jorge	m
José	m
Jovita	f
Julio	m
Leonor	f
Leticia	f
Marcelino	m
Marcelo	m
Marcos	m
Matilde	f
Maximiano	m
Maximiliano	m
Maximino	m
Miguel	m
Miguela	f
Moisés	m
Natanael	m
Nilda	f
Noemí	f
Óscar	m
Patricio	m
Paulino	m
Pedro	m
Plácido	m
Rafaela	f
Raimundo	m
Rebeca	f
Ricardo	m
Roque	m
Ruy	m
Santiago	m
Sol	f
Teófilo	m
Tiburcio	m
Vicente	m
Victorino	m
Raymundo	m
Josefa	f
Raquel	f
Hugo	m
Isabel	f
Débora	f
Manuel	m
Rafael	m
Tomás	m
Arsenio	m
Casimiro	m
Cecilio	m
Leandro	m
Lorena	f
Teobaldo	m
Vasco	m
Teresa	f
Rodrigo	m
Gaspar	m
Francisca	f
Isabela	f
Mariana	f
Manuela	f
Ana	f
Ema	f
Ramona	f
Anastas	m
Margarita	f
Selena	f
Valentín	m
Josefina	f
Lourdes	f
Rut	f
Malena	f
