Patrik	m
Elva	f
Majken	f
Jonna	f
Frej	m
Freja	f
Malte	m
Urban	m
Petronella	f
Catharina	f
Janna	f
Vincent	m
Roger	m
Eric	m
Katrina	f
Elsa	f
Virginia	f
Cecilia	f
Evelina	f
Rebecca	f
Felicia	f
Erica	f
Lennie	mf
Lenny	m
Mathilda	f
Tilda	f
Matilda	f
Elina	f
Helmi	f
Janne	m
Klemens	m
Theresia	f
Gerhard	m
Magdalena	f
Katrin	f
Kerstin	f
Mattias	m
Michaela	f
Sibylla	f
Gabriella	f
Teodora	f
Dorotea	f
Agata	f
Susanna	f
Alfhild	f
Hedda	f
Ola	m
Truls	m
Sofia	f
Janina	f
Filippa	f
Vilma	f
Marta	f
Paulina	f
Josefina	f
Acke	m
Agda	f
Agneta	f
Åke	m
Alvar	m
Arnborg	f
Åsa	f
Asbjörn	m
Aslög	f
Barbro	f
Bengt	m
Bengta	f
Björne	m
Börje	m
Bosse	m
Cajsa	f
Carin	f
Carita	f
Catrine	f
Charlotta	f
Elof	m
Elov	m
Emelie	f
Esbjörn	m
Fredrika	f
Gittan	f
Gjord	m
Göran	m
Gösta	m
Gottfrid	m
Greger	m
Gunilla	f
Håkan	m
Halsten	m
Halvar	m
Hampus	m
Hasse	m
Henrika	f
Ingegärd	f
Inger	f
Isak	m
Jerk	m
Jerker	m
Jöran	m
Jörgen	m
Kai	f
Kaj	f
Kajsa	f
Karita	f
Kettil	m
Kia	f
Krister	m
Linn	f
Linnéa	f
Love	m
Lovisa	f
Ludde	m
Malin	f
Märta	f
Mårten	m
Merit	f
Moa	f
My	f
Nea	f
Nels	m
Noak	m
Olle	m
Olof	m
Olov	m
Örjan	m
Orvar	m
Pehr	m
Pelle	m
Pernilla	f
Rebecka	f
Roffe	m
Ronja	f
Sassa	f
Sigfrid	m
Sigvard	m
Solvig	f
Staffan	m
Stellan	m
Sten	m
Sture	m
Svea	f
Synnöve	f
Teresia	f
Tessan	f
Thorbjörn	m
Thorborg	f
Torbjörn	m
Torgny	m
Torkel	m
Tova	f
Tryggve	m
Ture	m
Tyko	m
Ulrica	f
Vendela	f
Viveka	f
Bo	m
Christer	m
Erland	m
Thorsten	m
Torsten	m
Cilla	f
Rika	f
Annika	f
Fredrik	m
Hillevi	f
Kalle	m
Lotta	f
Niklas	m
Vilhelmina	f
Gustaf	m
Sören	m
Björn	m
Greta	f
Rut	f
Alva	f
Kjell	m
Kjerstin	f
Marit	f
Marita	f
Mats	m
Matteus	m
Milly	f
Nils	m
Pål	m
Petter	m
Tuva	f
Tomas	m
Malena	f
