Ahmed	m
Musa	m
Yahya	m
Yunus	m
Yusuf	m
Arzu	f
Bahar	f
Banu	f
Adem	m
Ahmet	m
Alp	m
Altan	m
Asil	m
Aslan	m
Asli	f
Ata	m
Aydin	m
Aygül	f
Ayla	f
Aylin	f
Ayse	f
Aysu	f
Aysun	f
Baris	m
Basak	f
Belgin	f
Berk	m
Berkant	m
Berker	m
Berna	f
Bilge	f
Bora	m
Çagatay	m
Can	m
Canan	f
Ceren	f
Coskun	m
Deniz	mf
Derya	mf
Dilara	f
Dilek	f
Direnç	m
Duygu	mf
Ebru	f
Ece	f
Eda	f
Ediz	m
Ekin	f
Elif	f
Elmas	f
Emel	f
Emin	m
Emine	f
Emir	m
Emre	m
Ender	m
Engin	m
Erdem	m
Eren	m
Erol	m
Esen	f
Eser	mf
Esin	f
Evren	mf
Fidan	f
Filiz	f
Firat	m
Gaye	f
Gizem	f
Göker	m
Gonca	f
Gözde	f
Gül	f
Gülay	f
Gülbahar	f
Gülistan	f
Hakan	m
Hande	f
Havva	f
Hazan	f
Hikmet	m
Ibrahim	m
Ilhami	m
Ilkay	mf
Ilker	m
Ipek	f
Irmak	f
Iskender	m
Kader	f
Kadri	m
Kelebek	f
Kiraz	f
Koray	m
Kudret	m
Levent	m
Mehmed	m
Mehmet	m
Melek	f
Meryem	f
Metin	m
Müge	f
Muhammet	m
Murat	m
Nergis	f
Nesrin	f
Nilüfer	f
Nuray	f
Ömer	m
Onur	m
Osman	m
Ozan	m
Özge	f
Özgür	mf
Özlem	f
Pembe	f
Pinar	f
Savas	m
Sebnem	f
Selim	m
Serhan	m
Serhat	m
Serkan	m
Sevgi	f
Simge	f
Soner	m
Su	f
Süleiman	m
Süleyman	m
Temel	m
Tolga	m
Tülay	f
Tunç	m
Turgay	m
Tutku	mf
Ufuk	m
Umut	mf
Volkan	m
Yagmur	f
Yakup	m
Yavuz	m
Yeter	f
Yildiz	f
Yonca	f
Zeki	m
Zeynep	f
Aysel	f
Ilkin	m
Sevda	f
