Bohuslav	m
Bohdan	m
Bohuslava	f
Adam	m
Anton	m
Borys	m
Lyubov	f
Viktoriya	f
Ivan	m
Roman	m
Alla	f
Lesya	f
Lilia	f
Lilya	f
Luba	f
Lyuba	f
Lyubochka	f
Nataliya	f
Nazar	m
Sofiya	f
Yuri	m
Yuriy	m
Anastasiya	f
Liliya	f
Mariya	f
Hanna	f
Viktor	m
Klara	f
Andriy	m
Dariya	f
Daryna	f
Denys	m
Dmytro	m
Fedir	m
Halyna	f
Hryhoriy	m
Iryna	f
Kalyna	f
Kateryna	f
Kostyantyn	m
Kyrylo	m
Lyudmyla	f
Mikhailo	m
Mykhaila	f
Mykhailo	m
Mykhaylo	m
Mykola	m
Mykyta	m
Oleksander	m
Oleksandr	m
Oleksandra	f
Oleksiy	m
Olena	f
Pavlo	m
Pylyp	m
Serhiy	m
Svitlana	f
Symon	m
Vasyl	m
Vasylyna	f
Vira	f
Volodymyr	m
Wasyl	m
Wasylyna	f
Wolodymyr	m
Yakiv	m
Yevheniy	m
Yosyp	m
Marko	m
Petro	m
Natalka	f
Oksana	f
Oxana	f
Taras	m
Martyn	m
