Avra	f
Caitria	f
Delphinia	f
Elario	m
Elfa	f
Felina	f
Filbert	m
Inglebert	m
Kaolin	m
Lanty	m
Lemmy	m
Maresol	f
Media	f
Melle	f
Monta	f
Narca	f
Ossia	f
Tria	f
Xara	f
Zephyra	f
Zeta	f
Amedeus	m
Calix	m
Chania	f
Clovia	f
Dezi	m
Elidi	f
Eulia	f
Fairuza	f
Fonsie	m
Fredo	m
Gilbertine	f
Gostislav	f
Iola	f
Isleen	f
Japeth	m
Jayel	f
Kelda	f
Lalia	f
Leolin	m
Lyda	f
Mayim	f
Mehalia	f
Melesina	f
Quintella	f
Xylia	f
Zenia	f
Zephania	m
