Lan	f
An	mf
Bao	m
Bich	f
Binh	mf
Cam	f
Chau	f
Chi	f
Cúc	f
Dinh	m
Duc	m
Dung	m
Duong	m
Hoa	f
Hòng	f
Hue	f
Hùng	m
Hùong	f
Kim (3)	f
Lành	m
Lien	f
Linh	f
Mai	f
Minh	m
Ngai	m
Ngoc	f
Nguyen	m
Nguyet	f
Nhung	mf
Phuong	f
Quan	m
Quang	m
Quy	mf
Quyen	f
Thanh	mf
Thi	f
Thu	f
Thuán	m
Thuy	f
Tien	f
Trai	m
Trúc	mf
Tu	mf
Tuan	m
Tuyên	f
Tuyet	f
Vân	mf
Van	m
Vien	m
Vinh	mf
Xuan	mf
Yen	f
