Arthur	m
Elaine	f
Aeron	mf
Arawn	m
Beli	m
Cai	m
Gahariet	m
Galahad	m
Govannon	m
Guenevere	f
Guinevere	f
Gwenhwyfar	f
Igraine	f
Kay	m
Lancelot	m
Lleu	m
Llyr	m
Lunete	f
Morgaine	f
Morgan	f
Morgen	f
Myrddin	m
Nimue	f
Nudd	m
Perceval	m
Peredur	m
Yvain	m
Ywain	m
Merlin	m
Percival	m
Gareth	m
Dylan	m
Rhiannon	f
Angharad	f
Aranrhod	f
Arianrhod	f
Bedwyr	m
Blodeuwedd	f
Ceridwen	f
Culhwch	m
Enid	f
Gawain	m
Geraint	m
Goronwy	m
Llew	m
Luned	f
Mabon	m
Owain	m
Pryderi	m
Urien	m
