Abena	f
Adjoa	f
Adwoa	f
Afia	f
Afua	f
Akosua	f
Akua	f
Ama	f
Anan	mf
Awotwi	mf
Baako	mf
Berko	m
Bosede	m
Dubaku	mf
Efua	f
Ekua	f
Emem	mf
Enu	mf
Esi	f
Ime	mf
Kobina	m
Kofi	m
Kojo	m
Kunto	f
Kwabena	m
Kwadwo	m
Kwaku	m
Kwame	m
Kwasi	m
Kweku	m
Kwesi	m
Lumusi	f
Mamadou	m
Nkruma	mf
Nsia	mf
Nsonowa	mf
Thema	f
Uduak	mf
Yaa	f
Yaw	m
