Falk	m
Alte	f
Alter	m
Anshel	m
Avrum	m
Baila	f
Benesh	m
Ber	m
Beylke	f
Bluma	f
Charna	f
Chatzkel	m
Dovid	m
Dudel	m
Eidel	f
Evron	m
Faiga	f
Faigel	f
Faivish	m
Fayvel	m
Feibush	m
Feige	f
Feivel	m
Fishel	m
Fishke	m
Freyde	f
Fruma	f
Gavrel	m
Gittel	f
Gluke	f
Glukel	f
Golda	f
Haskel	m
Hena	f
Henda	f
Hendel	f
Hene	f
Henye	f
Herschel	m
Hersh	m
Hershel	m
Heshel	m
Hirsh	m
Hirshel	m
Hode	f
Hodel	f
Hudes	f
Hyman	m
Hymie	m
Iser	m
Issur	m
Kaila	f
Kapel	m
Kayla	f
Koppel	m
Kreindel	f
Kreine	f
Lazer	m
Leeba	f
Lieber	m
Mendel	m
Meyer	m
Mirele	f
Moishe	m
Motel	m
Motke	m
Perele	f
Perle	f
Raisa	f
Raisel	f
Rayna	f
Reina	f
Rifka	f
Ruchel	f
Sekel	m
Selig	m
Sender	m
Shaina	f
Shaindel	f
Shayna	f
Shaynah	f
Sheine	f
Shimmel	m
Shprintza	f
Shprintze	f
Shprintzel	f
Sisel	f
Sroel	m
Suri	f
Teivel	m
Tevye	m
Toiba	f
Tzeitel	f
Tzofiya	f
Velvel	m
Velvela	f
Yankel	m
Yente	f
Yentl	f
Yidel	m
Yudel	m
Yussel	m
Yutke	f
Zalman	m
Zelda	f
Zelde	f
Zelig	m
Zisel	f
Zlota	f
Zusa	f
Zusman	m
