Abeni	f
Abidemi	m
Abimbola	mf
Abiodun	mf
Abioye	m
Adebowale	mf
Adegoke	m
Adetokunbo	mf
Adisa	m
Afolabi	m
Alaba	f
Amadi	m
Ayo	mf
Ayodele	mf
Ayokunle	m
Ayomide	mf
Ayotunde	mf
Babajide	m
Babatunde	m
Bamidele	m
Bolanle	f
Dada	f
Dayo	f
Ekundayo	mf
Eniola	mf
Enitan	m
Femi	m
Folami	mf
Gbemisola	f
Idowu	mf
Ife	f
Ige	f
Kayin	mf
Kayode	m
Lekan	m
Mojisola	f
Monifa	f
Olabode	m
Olamide	f
Olufemi	m
Olufunke	mf
Olufunmilayo	mf
Olufunmilola	mf
Olujimi	m
Olukayode	m
Olumide	m
Oluwafunmilayo	mf
Oluwasegun	mf
Oluwaseun	mf
Oluwaseyi	mf
Oluwatoyin	mf
Oluwayemisi	mf
Omobolanle	mf
Omolara	f
Oni	f
Opeyemi	m
Simisola	f
Temitope	mf
Titilayo	f
Yejide	f
Yewande	f
